abaixo	abaixo	_
abananada	abananadamente	Abbr=Yes
abananadamente	abananadamente	_
abelhuda	abelhudamente	Abbr=Yes
abelhudamente	abelhudamente	_
aberta	abertamente	Abbr=Yes
abertamente	abertamente	_
abismal	abismalmente	Abbr=Yes
abismalmente	abismalmente	_
abissal	abissalmente	Abbr=Yes
abissalmente	abissalmente	_
abjeta	abjetamente	Abbr=Yes
abjetamente	abjetamente	_
abolicionista	abolicionistamente	Abbr=Yes
abolicionistamente	abolicionistamente	_
aborigine	aboriginemente	Abbr=Yes
aboriginemente	aboriginemente	_
abrangedora	abrangedoramente	Abbr=Yes
abrangedoramente	abrangedoramente	_
abreviada	abreviadamente	Abbr=Yes
abreviadamente	abreviadamente	_
abrupta	abruptamente	Abbr=Yes
abruptamente	abruptamente	_
absoluta	absolutamente	Abbr=Yes
absolutamente	absolutamente	_
absorvente	absorventemente	Abbr=Yes
absorventemente	absorventemente	_
abstinente	abstinentemente	Abbr=Yes
abstinentemente	abstinentemente	_
abstracionista	abstracionistamente	Abbr=Yes
abstracionistamente	abstracionistamente	_
abstrata	abstratamente	Abbr=Yes
abstratamente	abstratamente	_
absurda	absurdamente	Abbr=Yes
absurdamente	absurdamente	_
abundante	abundantemente	Abbr=Yes
abundantemente	abundantemente	_
abusiva	abusivamente	Abbr=Yes
abusivamente	abusivamente	_
acaciana	acacianamente	Abbr=Yes
acacianamente	acacianamente	_
academica	academicamente	Abbr=Yes
academicamente	academicamente	_
acalorada	acaloradamente	Abbr=Yes
acaloradamente	acaloradamente	_
acanhada	acanhadamente	Abbr=Yes
acanhadamente	acanhadamente	_
acelerada	aceleradamente	Abbr=Yes
aceleradamente	aceleradamente	_
acentuada	acentuadamente	Abbr=Yes
acentuadamente	acentuadamente	_
acentual	acentualmente	Abbr=Yes
acentualmente	acentualmente	_
acerba	acerbamente	Abbr=Yes
acerbamente	acerbamente	_
acerca	acerca	_
acertada	acertadamente	Abbr=Yes
acertadamente	acertadamente	_
acessoria	acessoriamente	Abbr=Yes
acessoriamente	acessoriamente	_
acida	acidamente	Abbr=Yes
acidamente	acidamente	_
acidental	acidentalmente	Abbr=Yes
acidentalmente	acidentalmente	_
acima	acima	_
acintosa	acintosamente	Abbr=Yes
acintosamente	acintosamente	_
acionaria	acionariamente	Abbr=Yes
acionariamente	acionariamente	_
acirrada	acirradamente	Abbr=Yes
acirradamente	acirradamente	_
acolá	acolá	_
acrobatica	acrobaticamente	Abbr=Yes
acrobaticamente	acrobaticamente	_
acumulada	acumuladamente	Abbr=Yes
acumuladamente	acumuladamente	_
acusadora	acusadoramente	Abbr=Yes
acusadoramente	acusadoramente	_
acusatoria	acusatoriamente	Abbr=Yes
acusatoriamente	acusatoriamente	_
acustica	acusticamente	Abbr=Yes
acusticamente	acusticamente	_
ademais	ademais	_
adentro	adentro	_
adequada	adequadamente	Abbr=Yes
adequadamente	adequadamente	_
aderente	aderentemente	Abbr=Yes
aderentemente	aderentemente	_
adesiva	adesivamente	Abbr=Yes
adesivamente	adesivamente	_
adiantada	adiantadamente	Abbr=Yes
adiantadamente	adiantadamente	_
adiante	adiante	_
adicional	adicionalmente	Abbr=Yes
adicionalmente	adicionalmente	_
adiposa	adiposamente	Abbr=Yes
adiposamente	adiposamente	_
aditiva	aditivamente	Abbr=Yes
aditivamente	aditivamente	_
adjetival	adjetivalmente	Abbr=Yes
adjetivalmente	adjetivalmente	_
administrativa	administrativamente	Abbr=Yes
administrativamente	administrativamente	_
admiravel	admiravelmente	Abbr=Yes
admiravelmente	admiravelmente	_
admitida	admitidamente	Abbr=Yes
admitidamente	admitidamente	_
adoravel	adoravelmente	Abbr=Yes
adoravelmente	adoravelmente	_
adultera	adulteramente	Abbr=Yes
adulteramente	adulteramente	_
adverbial	adverbialmente	Abbr=Yes
adverbialmente	adverbialmente	_
adversa	adversamente	Abbr=Yes
adversamente	adversamente	_
adversativa	adversativamente	Abbr=Yes
adversativamente	adversativamente	_
aerodinamica	aerodinamicamente	Abbr=Yes
aerodinamicamente	aerodinamicamente	_
afavel	afavelmente	Abbr=Yes
afavelmente	afavelmente	_
afetiva	afetivamente	Abbr=Yes
afetivamente	afetivamente	_
afetuosa	afetuosamente	Abbr=Yes
afetuosamente	afetuosamente	_
afinal	afinal	_
afirmativa	afirmativamente	Abbr=Yes
afirmativamente	afirmativamente	_
aflitiva	aflitivamente	Abbr=Yes
aflitivamente	aflitivamente	_
afluente	afluentemente	Abbr=Yes
afluentemente	afluentemente	_
afoita	afoitamente	Abbr=Yes
afoitamente	afoitamente	_
afora	afora	_
afortunada	afortunadamente	Abbr=Yes
afortunadamente	afortunadamente	_
agil	agilmente	Abbr=Yes
agilmente	agilmente	_
agonizante	agonizantemente	Abbr=Yes
agonizantemente	agonizantemente	_
agora	agora	_
agorinha	agorinha	_
agradavel	agradavelmente	Abbr=Yes
agradavelmente	agradavelmente	_
agressiva	agressivamente	Abbr=Yes
agressivamente	agressivamente	_
agricola	agricolamente	Abbr=Yes
agricolamente	agricolamente	_
agridoce	agridocemente	Abbr=Yes
agridocemente	agridocemente	_
aguda	agudamente	Abbr=Yes
agudamente	agudamente	_
ainda	ainda	_
alardemente	alardemente	_
alarmante	alarmantemente	Abbr=Yes
alarmantemente	alarmantemente	_
alcoolica	alcoolicamente	Abbr=Yes
alcoolicamente	alcoolicamente	_
aleatoria	aleatoriamente	Abbr=Yes
aleatoriamente	aleatoriamente	_
alegorica	alegoricamente	Abbr=Yes
alegoricamente	alegoricamente	_
alegre	alegremente	Abbr=Yes
alegremente	alegremente	_
alergica	alergicamente	Abbr=Yes
alergicamente	alergicamente	_
alerta	alertamente	Abbr=Yes
alertada	alertadamente	Abbr=Yes
alertadamente	alertadamente	_
alertamente	alertamente	_
alfabetica	alfabeticamente	Abbr=Yes
alfabeticamente	alfabeticamente	_
algebrica	algebricamente	Abbr=Yes
algebricamente	algebricamente	_
algo	algo	_
algures	algures	_
alhures	alhures	_
ali	ali	_
alienada	alienadamente	Abbr=Yes
alienadamente	alienadamente	_
alinhada	alinhadamente	Abbr=Yes
alinhadamente	alinhadamente	_
aliás	aliás	_
alpina	alpinamente	Abbr=Yes
alpinamente	alpinamente	_
alpinista	alpinistamente	Abbr=Yes
alpinistamente	alpinistamente	_
alta	altamente	Abbr=Yes
altamente	altamente	_
alternada	alternadamente	Abbr=Yes
alternadamente	alternadamente	_
alternativa	alternativamente	Abbr=Yes
alternativamente	alternativamente	_
altissima	altissimamente	Abbr=Yes
altissimamente	altissimamente	_
alto	alto	_
altruista	altruistamente	Abbr=Yes
altruistamente	altruistamente	_
alucinada	alucinadamente	Abbr=Yes
alucinadamente	alucinadamente	_
alucinante	alucinantemente	Abbr=Yes
alucinantemente	alucinantemente	_
alvissareira	alvissareiramente	Abbr=Yes
alvissareiramente	alvissareiramente	_
além	além	_
amalucada	amalucadamente	Abbr=Yes
amalucadamente	amalucadamente	_
amanhã	amanhã	_
amarga	amargamente	Abbr=Yes
amargamente	amargamente	_
amargurada	amarguradamente	Abbr=Yes
amarguradamente	amarguradamente	_
amavel	amavelmente	Abbr=Yes
amavelmente	amavelmente	_
amazonica	amazonicamente	Abbr=Yes
amazonicamente	amazonicamente	_
ambiental	ambientalmente	Abbr=Yes
ambientalmente	ambientalmente	_
ambigua	ambiguamente	Abbr=Yes
ambiguamente	ambiguamente	_
ambulante	ambulantemente	Abbr=Yes
ambulantemente	ambulantemente	_
ameaçadora	ameaçadoramente	Abbr=Yes
ameaçadoramente	ameaçadoramente	_
amedrontadora	amedrontadoramente	Abbr=Yes
amedrontadoramente	amedrontadoramente	_
amena	amenamente	Abbr=Yes
amenamente	amenamente	_
amendoada	amendoadamente	Abbr=Yes
amendoadamente	amendoadamente	_
americana	americanamente	Abbr=Yes
americanamente	americanamente	_
americanista	americanistamente	Abbr=Yes
americanistamente	americanistamente	_
amiga	amigamente	Abbr=Yes
amigamente	amigamente	_
amigavel	amigavelmente	Abbr=Yes
amigavelmente	amigavelmente	_
amistosa	amistosamente	Abbr=Yes
amistosamente	amistosamente	_
amiúde	amiúde	_
amoral	amoralmente	Abbr=Yes
amoralmente	amoralmente	_
amorosa	amorosamente	Abbr=Yes
amorosamente	amorosamente	_
ampla	amplamente	Abbr=Yes
amplamente	amplamente	_
anacronica	anacronicamente	Abbr=Yes
anacronicamente	anacronicamente	_
anagramatica	anagramaticamente	Abbr=Yes
anagramaticamente	anagramaticamente	_
analitica	analiticamente	Abbr=Yes
analiticamente	analiticamente	_
analoga	analogamente	Abbr=Yes
analogamente	analogamente	_
analogica	analogicamente	Abbr=Yes
analogicamente	analogicamente	_
anarquica	anarquicamente	Abbr=Yes
anarquicamente	anarquicamente	_
anarquista	anarquistamente	Abbr=Yes
anarquistamente	anarquistamente	_
anatomica	anatomicamente	Abbr=Yes
anatomicamente	anatomicamente	_
ancestral	ancestralmente	Abbr=Yes
ancestralmente	ancestralmente	_
angelica	angelicamente	Abbr=Yes
angelical	angelicalmente	Abbr=Yes
angelicalmente	angelicalmente	_
angelicamente	angelicamente	_
angustiada	angustiadamente	Abbr=Yes
angustiadamente	angustiadamente	_
angustiante	angustiantemente	Abbr=Yes
angustiantemente	angustiantemente	_
animada	animadamente	Abbr=Yes
animadamente	animadamente	_
animica	animicamente	Abbr=Yes
animicamente	animicamente	_
anonima	anonimamente	Abbr=Yes
anonimamente	anonimamente	_
anormal	anormalmente	Abbr=Yes
anormalmente	anormalmente	_
ansiada	ansiadamente	Abbr=Yes
ansiadamente	ansiadamente	_
ansiosa	ansiosamente	Abbr=Yes
ansiosamente	ansiosamente	_
antagonica	antagonicamente	Abbr=Yes
antagonicamente	antagonicamente	_
antagonista	antagonistamente	Abbr=Yes
antagonistamente	antagonistamente	_
ante	ante	_
antecedente	antecedentemente	Abbr=Yes
antecedentemente	antecedentemente	_
antecipada	antecipadamente	Abbr=Yes
antecipadamente	antecipadamente	_
antemanhã	antemanhã	_
anteontem	anteontem	_
anterior	anteriormente	Abbr=Yes
anteriormente	anteriormente	_
antes	antes	_
antiga	antigamente	Abbr=Yes
antigamente	antigamente	_
antropomorfica	antropomorficamente	Abbr=Yes
antropomorficamente	antropomorficamente	_
anual	anualmente	Abbr=Yes
anualmente	anualmente	_
aonde	aonde	_
apaixonada	apaixonadamente	Abbr=Yes
apaixonadamente	apaixonadamente	_
aparente	aparentemente	Abbr=Yes
aparentemente	aparentemente	_
apenas	apenas	_
apesar	apesar	_
apreciavel	apreciavelmente	Abbr=Yes
apreciavelmente	apreciavelmente	_
apressada	apressadamente	Abbr=Yes
apressadamente	apressadamente	_
aprobativa	aprobativamente	Abbr=Yes
aprobativamente	aprobativamente	_
apropriada	apropriadamente	Abbr=Yes
apropriadamente	apropriadamente	_
aproximada	aproximadamente	Abbr=Yes
aproximadamente	aproximadamente	_
aproximativa	aproximativamente	Abbr=Yes
aproximativamente	aproximativamente	_
apurada	apuradamente	Abbr=Yes
apuradamente	apuradamente	_
aqui	aqui	_
aquém	aquém	_
arbitraria	arbitrariamente	Abbr=Yes
arbitrariamente	arbitrariamente	_
arcangelicamente	arcangelicamente	_
ardente	ardentemente	Abbr=Yes
ardentemente	ardentemente	_
ardilosa	ardilosamente	Abbr=Yes
ardilosamente	ardilosamente	_
ardorosa	ardorosamente	Abbr=Yes
ardorosamente	ardorosamente	_
ardua	arduamente	Abbr=Yes
arduamente	arduamente	_
arguta	argutamente	Abbr=Yes
argutamente	argutamente	_
arida	aridamente	Abbr=Yes
aridamente	aridamente	_
aristocratica	aristocraticamente	Abbr=Yes
aristocraticamente	aristocraticamente	_
aritmetica	aritmeticamente	Abbr=Yes
aritmeticamente	aritmeticamente	_
armamentista	armamentistamente	Abbr=Yes
armamentistamente	armamentistamente	_
aromatica	aromaticamente	Abbr=Yes
aromaticamente	aromaticamente	_
arquitetonica	arquitetonicamente	Abbr=Yes
arquitetonicamente	arquitetonicamente	_
arraigada	arraigadamente	Abbr=Yes
arraigadamente	arraigadamente	_
arrasadora	arrasadoramente	Abbr=Yes
arrasadoramente	arrasadoramente	_
arrebatada	arrebatadamente	Abbr=Yes
arrebatadamente	arrebatadamente	_
arrogante	arrogantemente	Abbr=Yes
arrogantemente	arrogantemente	_
artesanal	artesanalmente	Abbr=Yes
artesanalmente	artesanalmente	_
articulada	articuladamente	Abbr=Yes
articuladamente	articuladamente	_
artificial	artificialmente	Abbr=Yes
artificialmente	artificialmente	_
artificiosa	artificiosamente	Abbr=Yes
artificiosamente	artificiosamente	_
artistica	artisticamente	Abbr=Yes
artisticamente	artisticamente	_
ascendente	ascendentemente	Abbr=Yes
ascendentemente	ascendentemente	_
asfixiante	asfixiantemente	Abbr=Yes
asfixiantemente	asfixiantemente	_
asiatica	asiaticamente	Abbr=Yes
asiaticamente	asiaticamente	_
aspera	asperamente	Abbr=Yes
asperamente	asperamente	_
assanhada	assanhadamente	Abbr=Yes
assanhadamente	assanhadamente	_
assaz	assaz	_
asseptica	assepticamente	Abbr=Yes
assepticamente	assepticamente	_
assertiva	assertivamente	Abbr=Yes
assertivamente	assertivamente	_
assexuada	assexuadamente	Abbr=Yes
assexuadamente	assexuadamente	_
assidua	assiduamente	Abbr=Yes
assiduamente	assiduamente	_
assim	assim	_
assimetrica	assimetricamente	Abbr=Yes
assimetricamente	assimetricamente	_
assistencial	assistencialmente	Abbr=Yes
assistencialmente	assistencialmente	_
assombrosa	assombrosamente	Abbr=Yes
assombrosamente	assombrosamente	_
assumida	assumidamente	Abbr=Yes
assumidamente	assumidamente	_
assustadora	assustadoramente	Abbr=Yes
assustadoramente	assustadoramente	_
astronautica	astronauticamente	Abbr=Yes
astronauticamente	astronauticamente	_
astronomica	astronomicamente	Abbr=Yes
astronomicamente	astronomicamente	_
astuciosa	astuciosamente	Abbr=Yes
astuciosamente	astuciosamente	_
astuta	astutamente	Abbr=Yes
astutamente	astutamente	_
atabalhoada	atabalhoadamente	Abbr=Yes
atabalhoadamente	atabalhoadamente	_
atenciosa	atenciosamente	Abbr=Yes
atenciosamente	atenciosamente	_
atenta	atentamente	Abbr=Yes
atentamente	atentamente	_
aterrorizante	aterrorizantemente	Abbr=Yes
aterrorizantemente	aterrorizantemente	_
ativa	ativamente	Abbr=Yes
ativamente	ativamente	_
atletica	atleticamente	Abbr=Yes
atleticamente	atleticamente	_
atomica	atomicamente	Abbr=Yes
atomicamente	atomicamente	_
atomistica	atomisticamente	Abbr=Yes
atomisticamente	atomisticamente	_
atordoada	atordoadamente	Abbr=Yes
atordoadamente	atordoadamente	_
através	através	_
atrevida	atrevidamente	Abbr=Yes
atrevidamente	atrevidamente	_
atropelada	atropeladamente	Abbr=Yes
atropeladamente	atropeladamente	_
atrás	atrás	_
atual	atualmente	Abbr=Yes
atualmente	atualmente	_
até	até	_
auditiva	auditivamente	Abbr=Yes
auditivamente	auditivamente	_
auspiciosa	auspiciosamente	Abbr=Yes
auspiciosamente	auspiciosamente	_
austera	austeramente	Abbr=Yes
austeramente	austeramente	_
autentica	autenticamente	Abbr=Yes
autenticamente	autenticamente	_
automatica	automaticamente	Abbr=Yes
automaticamente	automaticamente	_
autonoma	autonomamente	Abbr=Yes
autonomamente	autonomamente	_
autonomica	autonomicamente	Abbr=Yes
autonomicamente	autonomicamente	_
autoritaria	autoritariamente	Abbr=Yes
autoritariamente	autoritariamente	_
autorizada	autorizadamente	Abbr=Yes
autorizadamente	autorizadamente	_
avante	avante	_
avassaladora	avassaladoramente	Abbr=Yes
avassaladoramente	avassaladoramente	_
avida	avidamente	Abbr=Yes
avidamente	avidamente	_
azeda	azedamente	Abbr=Yes
azedamente	azedamente	_
azulada	azuladamente	Abbr=Yes
azuladamente	azuladamente	_
açodada	açodadamente	Abbr=Yes
açodadamente	açodadamente	_
aí	aí	_
bairrista	bairristamente	Abbr=Yes
bairristamente	bairristamente	_
baixo	baixo	_
balistica	balisticamente	Abbr=Yes
balisticamente	balisticamente	_
balzaquiana	balzaquianamente	Abbr=Yes
balzaquianamente	balzaquianamente	_
bamba	bambamente	Abbr=Yes
bambamente	bambamente	_
banal	banalmente	Abbr=Yes
banalmente	banalmente	_
bandoleira	bandoleiramente	Abbr=Yes
bandoleiramente	bandoleiramente	_
barato	barato	_
barbara	barbaramente	Abbr=Yes
barbaramente	barbaramente	_
barulhenta	barulhentamente	Abbr=Yes
barulhentamente	barulhentamente	_
basbaque	basbaquemente	Abbr=Yes
basbaquemente	basbaquemente	_
basica	basicamente	Abbr=Yes
basicamente	basicamente	_
bastante	bastante	_
batuta	batutamente	Abbr=Yes
batutamente	batutamente	_
bazofia	bazofiamente	Abbr=Yes
bazofiamente	bazofiamente	_
bela	belamente	Abbr=Yes
belamente	belamente	_
belica	belicamente	Abbr=Yes
belicamente	belicamente	_
belissima	belissimamente	Abbr=Yes
belissimamente	belissimamente	_
bem	bem	_
beneditina	beneditinamente	Abbr=Yes
beneditinamente	beneditinamente	_
benefica	beneficamente	Abbr=Yes
beneficamente	beneficamente	_
benevola	benevolamente	Abbr=Yes
benevolamente	benevolamente	_
benigna	benignamente	Abbr=Yes
benignamente	benignamente	_
besta	bestamente	Abbr=Yes
bestalhona	bestalhonamente	Abbr=Yes
bestalhonamente	bestalhonamente	_
bestamente	bestamente	_
bestial	bestialmente	Abbr=Yes
bestialmente	bestialmente	_
biblica	biblicamente	Abbr=Yes
biblicamente	biblicamente	_
bienal	bienalmente	Abbr=Yes
bienalmente	bienalmente	_
bifocal	bifocalmente	Abbr=Yes
bifocalmente	bifocalmente	_
bilateral	bilateralmente	Abbr=Yes
bilateralmente	bilateralmente	_
bimestral	bimestralmente	Abbr=Yes
bimestralmente	bimestralmente	_
binaria	binariamente	Abbr=Yes
binariamente	binariamente	_
biofisica	biofisicamente	Abbr=Yes
biofisicamente	biofisicamente	_
biografica	biograficamente	Abbr=Yes
biograficamente	biograficamente	_
biologica	biologicamente	Abbr=Yes
biologicamente	biologicamente	_
biometrica	biometricamente	Abbr=Yes
biometricamente	biometricamente	_
bionica	bionicamente	Abbr=Yes
bionicamente	bionicamente	_
bioquimica	bioquimicamente	Abbr=Yes
bioquimicamente	bioquimicamente	_
bisonha	bisonhamente	Abbr=Yes
bisonhamente	bisonhamente	_
bissexual	bissexualmente	Abbr=Yes
bissexualmente	bissexualmente	_
bizarra	bizarramente	Abbr=Yes
bizarramente	bizarramente	_
boba	bobamente	Abbr=Yes
bobamente	bobamente	_
bolchevista	bolchevistamente	Abbr=Yes
bolchevistamente	bolchevistamente	_
bombastica	bombasticamente	Abbr=Yes
bombasticamente	bombasticamente	_
bondosa	bondosamente	Abbr=Yes
bondosamente	bondosamente	_
botanica	botanicamente	Abbr=Yes
botanicamente	botanicamente	_
bovina	bovinamente	Abbr=Yes
bovinamente	bovinamente	_
boçal	boçalmente	Abbr=Yes
boçalmente	boçalmente	_
branda	brandamente	Abbr=Yes
brandamente	brandamente	_
brasileira	brasileiramente	Abbr=Yes
brasileiramente	brasileiramente	_
brasiliana	brasilianamente	Abbr=Yes
brasilianamente	brasilianamente	_
brava	bravamente	Abbr=Yes
bravamente	bravamente	_
braçal	braçalmente	Abbr=Yes
braçalmente	braçalmente	_
brejeira	brejeiramente	Abbr=Yes
brejeiramente	brejeiramente	_
breve	brevemente	Abbr=Yes
brevemente	brevemente	_
brilhante	brilhantemente	Abbr=Yes
brilhantemente	brilhantemente	_
britanica	britanicamente	Abbr=Yes
britanicamente	britanicamente	_
brusca	bruscamente	Abbr=Yes
bruscamente	bruscamente	_
bruta	brutamente	Abbr=Yes
brutal	brutalmente	Abbr=Yes
brutalmente	brutalmente	_
brutamente	brutamente	_
bucolica	bucolicamente	Abbr=Yes
bucolicamente	bucolicamente	_
burlesca	burlescamente	Abbr=Yes
burlescamente	burlescamente	_
burocratica	burocraticamente	Abbr=Yes
burocraticamente	burocraticamente	_
burra	burramente	Abbr=Yes
burramente	burramente	_
cabal	cabalmente	Abbr=Yes
cabalmente	cabalmente	_
cacarejante	cacarejantemente	Abbr=Yes
cacarejantemente	cacarejantemente	_
cadê	cadê	_
cafajeste	cafajestemente	Abbr=Yes
cafajestemente	cafajestemente	_
calculada	calculadamente	Abbr=Yes
calculadamente	calculadamente	_
calida	calidamente	Abbr=Yes
calidamente	calidamente	_
calma	calmamente	Abbr=Yes
calmamente	calmamente	_
calorosa	calorosamente	Abbr=Yes
calorosamente	calorosamente	_
caluniadora	caluniadoramente	Abbr=Yes
caluniadoramente	caluniadoramente	_
camarada	camaradamente	Abbr=Yes
camaradamente	camaradamente	_
cambial	cambialmente	Abbr=Yes
cambialmente	cambialmente	_
campestre	campestremente	Abbr=Yes
campestremente	campestremente	_
canalha	canalhamente	Abbr=Yes
canalhamente	canalhamente	_
candente	candentemente	Abbr=Yes
candentemente	candentemente	_
candida	candidamente	Abbr=Yes
candidamente	candidamente	_
canibal	canibalmente	Abbr=Yes
canibalmente	canibalmente	_
canina	caninamente	Abbr=Yes
caninamente	caninamente	_
canonica	canonicamente	Abbr=Yes
canonicamente	canonicamente	_
cansativa	cansativamente	Abbr=Yes
cansativamente	cansativamente	_
caotica	caoticamente	Abbr=Yes
caoticamente	caoticamente	_
capenga	capengamente	Abbr=Yes
capengada	capengadamente	Abbr=Yes
capengadamente	capengadamente	_
capengamente	capengamente	_
capengavel	capengavelmente	Abbr=Yes
capengavelmente	capengavelmente	_
capilar	capilarmente	Abbr=Yes
capilarmente	capilarmente	_
capitalista	capitalistamente	Abbr=Yes
capitalistamente	capitalistamente	_
caprichosa	caprichosamente	Abbr=Yes
caprichosamente	caprichosamente	_
caracteristica	caracteristicamente	Abbr=Yes
caracteristicamente	caracteristicamente	_
caracterizada	caracterizadamente	Abbr=Yes
caracterizadamente	caracterizadamente	_
carbonica	carbonicamente	Abbr=Yes
carbonicamente	carbonicamente	_
caricatural	caricaturalmente	Abbr=Yes
caricaturalmente	caricaturalmente	_
carinhosa	carinhosamente	Abbr=Yes
carinhosamente	carinhosamente	_
carnal	carnalmente	Abbr=Yes
carnalmente	carnalmente	_
carnavalesca	carnavalescamente	Abbr=Yes
carnavalescamente	carnavalescamente	_
caro	caro	_
cartesiana	cartesianamente	Abbr=Yes
cartesianamente	cartesianamente	_
casmurra	casmurramente	Abbr=Yes
casmurramente	casmurramente	_
casta	castamente	Abbr=Yes
castamente	castamente	_
casual	casualmente	Abbr=Yes
casualmente	casualmente	_
casuista	casuistamente	Abbr=Yes
casuistamente	casuistamente	_
casuistica	casuisticamente	Abbr=Yes
casuisticamente	casuisticamente	_
catastrofica	catastroficamente	Abbr=Yes
catastroficamente	catastroficamente	_
categorica	categoricamente	Abbr=Yes
categoricamente	categoricamente	_
causal	causalmente	Abbr=Yes
causalmente	causalmente	_
cauta	cautamente	Abbr=Yes
cautamente	cautamente	_
cautelar	cautelarmente	Abbr=Yes
cautelarmente	cautelarmente	_
cautelosa	cautelosamente	Abbr=Yes
cautelosamente	cautelosamente	_
cavalar	cavalarmente	Abbr=Yes
cavalarmente	cavalarmente	_
cavaleira	cavaleiramente	Abbr=Yes
cavaleiramente	cavaleiramente	_
cavalheira	cavalheiramente	Abbr=Yes
cavalheiramente	cavalheiramente	_
cavalheiresca	cavalheirescamente	Abbr=Yes
cavalheirescamente	cavalheirescamente	_
cavilosa	cavilosamente	Abbr=Yes
cavilosamente	cavilosamente	_
cedinho	cedinho	_
cedo	cedo	_
cega	cegamente	Abbr=Yes
cegamente	cegamente	_
celere	celeremente	Abbr=Yes
celeremente	celeremente	_
cenica	cenicamente	Abbr=Yes
cenicamente	cenicamente	_
cenografica	cenograficamente	Abbr=Yes
cenograficamente	cenograficamente	_
central	centralmente	Abbr=Yes
centralmente	centralmente	_
centrifuga	centrifugamente	Abbr=Yes
centrifugamente	centrifugamente	_
cerca	cerca	_
cerce	cerce	_
cerebral	cerebralmente	Abbr=Yes
cerebralmente	cerebralmente	_
cerrada	cerradamente	Abbr=Yes
cerradamente	cerradamente	_
certa	certamente	Abbr=Yes
certamente	certamente	_
certeira	certeiramente	Abbr=Yes
certeiramente	certeiramente	_
certo	certo	_
charmosa	charmosamente	Abbr=Yes
charmosamente	charmosamente	_
chocante	chocantemente	Abbr=Yes
chocantemente	chocantemente	_
chorosa	chorosamente	Abbr=Yes
chorosamente	chorosamente	_
chula	chulamente	Abbr=Yes
chulamente	chulamente	_
cibernetica	ciberneticamente	Abbr=Yes
ciberneticamente	ciberneticamente	_
ciclica	ciclicamente	Abbr=Yes
ciclicamente	ciclicamente	_
ciente	cientemente	Abbr=Yes
cientemente	cientemente	_
cientifica	cientificamente	Abbr=Yes
cientificamente	cientificamente	_
cilindrica	cilindricamente	Abbr=Yes
cilindricamente	cilindricamente	_
cinematica	cinematicamente	Abbr=Yes
cinematicamente	cinematicamente	_
cinematografica	cinematograficamente	Abbr=Yes
cinematograficamente	cinematograficamente	_
cinica	cinicamente	Abbr=Yes
cinicamente	cinicamente	_
cintilante	cintilantemente	Abbr=Yes
cintilantemente	cintilantemente	_
ciosa	ciosamente	Abbr=Yes
ciosamente	ciosamente	_
circular	circularmente	Abbr=Yes
circularmente	circularmente	_
circunstancial	circunstancialmente	Abbr=Yes
circunstancialmente	circunstancialmente	_
cirurgica	cirurgicamente	Abbr=Yes
cirurgicamente	cirurgicamente	_
ciumenta	ciumentamente	Abbr=Yes
ciumentamente	ciumentamente	_
civica	civicamente	Abbr=Yes
civicamente	civicamente	_
civil	civilmente	Abbr=Yes
civilmente	civilmente	_
clandestina	clandestinamente	Abbr=Yes
clandestinamente	clandestinamente	_
clara	claramente	Abbr=Yes
claramente	claramente	_
claro	claro	_
classica	classicamente	Abbr=Yes
classicamente	classicamente	_
clinica	clinicamente	Abbr=Yes
clinicamente	clinicamente	_
coercitiva	coercitivamente	Abbr=Yes
coercitivamente	coercitivamente	_
coerente	coerentemente	Abbr=Yes
coerentemente	coerentemente	_
cognitiva	cognitivamente	Abbr=Yes
cognitivamente	cognitivamente	_
coincidente	coincidentemente	Abbr=Yes
coincidentemente	coincidentemente	_
colateral	colateralmente	Abbr=Yes
colateralmente	colateralmente	_
coletiva	coletivamente	Abbr=Yes
coletivamente	coletivamente	_
colonial	colonialmente	Abbr=Yes
colonialmente	colonialmente	_
coloquial	coloquialmente	Abbr=Yes
coloquialmente	coloquialmente	_
combinada	combinadamente	Abbr=Yes
combinadamente	combinadamente	_
comedida	comedidamente	Abbr=Yes
comedidamente	comedidamente	_
comemorativa	comemorativamente	Abbr=Yes
comemorativamente	comemorativamente	_
comercial	comercialmente	Abbr=Yes
comercialmente	comercialmente	_
comica	comicamente	Abbr=Yes
comicamente	comicamente	_
comiserativa	comiserativamente	Abbr=Yes
comiserativamente	comiserativamente	_
como	como	_
comoda	comodamente	Abbr=Yes
comodamente	comodamente	_
comovedora	comovedoramente	Abbr=Yes
comovedoramente	comovedoramente	_
comovente	comoventemente	Abbr=Yes
comoventemente	comoventemente	_
compacta	compactamente	Abbr=Yes
compactamente	compactamente	_
comparativa	comparativamente	Abbr=Yes
comparativamente	comparativamente	_
competente	competentemente	Abbr=Yes
competentemente	competentemente	_
competitiva	competitivamente	Abbr=Yes
competitivamente	competitivamente	_
complacente	complacentemente	Abbr=Yes
complacentemente	complacentemente	_
complementar	complementarmente	Abbr=Yes
complementarmente	complementarmente	_
completa	completamente	Abbr=Yes
completamente	completamente	_
complexa	complexamente	Abbr=Yes
complexamente	complexamente	_
compositamente	compositamente	_
compreensivel	compreensivelmente	Abbr=Yes
compreensivelmente	compreensivelmente	_
comprovada	comprovadamente	Abbr=Yes
comprovadamente	comprovadamente	_
compulsiva	compulsivamente	Abbr=Yes
compulsivamente	compulsivamente	_
compulsoria	compulsoriamente	Abbr=Yes
compulsoriamente	compulsoriamente	_
computacional	computacionalmente	Abbr=Yes
computacionalmente	computacionalmente	_
comu	comumente	Abbr=Yes
comumente	comumente	_
comunitaria	comunitariamente	Abbr=Yes
comunitariamente	comunitariamente	_
concebivel	concebivelmente	Abbr=Yes
concebivelmente	concebivelmente	_
conceitual	conceitualmente	Abbr=Yes
conceitualmente	conceitualmente	_
conceituosa	conceituosamente	Abbr=Yes
conceituosamente	conceituosamente	_
concernente	concernentemente	Abbr=Yes
concernentemente	concernentemente	_
concisa	concisamente	Abbr=Yes
concisamente	concisamente	_
conclusiva	conclusivamente	Abbr=Yes
conclusivamente	conclusivamente	_
concomitante	concomitantemente	Abbr=Yes
concomitantemente	concomitantemente	_
concorrente	concorrentemente	Abbr=Yes
concorrentemente	concorrentemente	_
concreta	concretamente	Abbr=Yes
concretamente	concretamente	_
condenavel	condenavelmente	Abbr=Yes
condenavelmente	condenavelmente	_
condicional	condicionalmente	Abbr=Yes
condicionalmente	condicionalmente	_
condigna	condignamente	Abbr=Yes
condignamente	condignamente	_
condizente	condizentemente	Abbr=Yes
condizentemente	condizentemente	_
confessa	confessamente	Abbr=Yes
confessada	confessadamente	Abbr=Yes
confessadamente	confessadamente	_
confessamente	confessamente	_
confiante	confiantemente	Abbr=Yes
confiantemente	confiantemente	_
confidencial	confidencialmente	Abbr=Yes
confidencialmente	confidencialmente	_
confidente	confidentemente	Abbr=Yes
confidentemente	confidentemente	_
confortavel	confortavelmente	Abbr=Yes
confortavelmente	confortavelmente	_
confronte	confronte	_
confusa	confusamente	Abbr=Yes
confusamente	confusamente	_
congenita	congenitamente	Abbr=Yes
congenitamente	congenitamente	_
conhecida	conhecidamente	Abbr=Yes
conhecidamente	conhecidamente	_
conjectural	conjecturalmente	Abbr=Yes
conjecturalmente	conjecturalmente	_
conjugal	conjugalmente	Abbr=Yes
conjugalmente	conjugalmente	_
conjunta	conjuntamente	Abbr=Yes
conjuntamente	conjuntamente	_
conjuntural	conjunturalmente	Abbr=Yes
conjunturalmente	conjunturalmente	_
conscienciosa	conscienciosamente	Abbr=Yes
conscienciosamente	conscienciosamente	_
consciente	conscientemente	Abbr=Yes
conscientemente	conscientemente	_
consecutiva	consecutivamente	Abbr=Yes
consecutivamente	consecutivamente	_
conseguinte	conseguintemente	Abbr=Yes
conseguintemente	conseguintemente	_
consensual	consensualmente	Abbr=Yes
consensualmente	consensualmente	_
consequente	consequentemente	Abbr=Yes
consequentemente	consequentemente	_
conservadora	conservadoramente	Abbr=Yes
conservadoramente	conservadoramente	_
considerada	consideradamente	Abbr=Yes
consideradamente	consideradamente	_
consideravel	consideravelmente	Abbr=Yes
consideravelmente	consideravelmente	_
consistente	consistentemente	Abbr=Yes
consistentemente	consistentemente	_
conspirativa	conspirativamente	Abbr=Yes
conspirativamente	conspirativamente	_
constante	constantemente	Abbr=Yes
constantemente	constantemente	_
constitucional	constitucionalmente	Abbr=Yes
constitucionalista	constitucionalistamente	Abbr=Yes
constitucionalistamente	constitucionalistamente	_
constitucionalmente	constitucionalmente	_
constrangedora	constrangedoramente	Abbr=Yes
constrangedoramente	constrangedoramente	_
constringente	constringentemente	Abbr=Yes
constringentemente	constringentemente	_
constrita	constritamente	Abbr=Yes
constritamente	constritamente	_
construtiva	construtivamente	Abbr=Yes
construtivamente	construtivamente	_
consubstancial	consubstancialmente	Abbr=Yes
consubstancialmente	consubstancialmente	_
contabil	contabilmente	Abbr=Yes
contabilmente	contabilmente	_
contanto	contanto	_
contempladora	contempladoramente	Abbr=Yes
contempladoramente	contempladoramente	_
contemplativa	contemplativamente	Abbr=Yes
contemplativamente	contemplativamente	_
contemporanea	contemporaneamente	Abbr=Yes
contemporaneamente	contemporaneamente	_
continua	continuamente	Abbr=Yes
continuada	continuadamente	Abbr=Yes
continuadamente	continuadamente	_
continuamente	continuamente	_
contraditoria	contraditoriamente	Abbr=Yes
contraditoriamente	contraditoriamente	_
contrapontistica	contrapontisticamente	Abbr=Yes
contrapontisticamente	contrapontisticamente	_
contraria	contrariamente	Abbr=Yes
contrariamente	contrariamente	_
contratual	contratualmente	Abbr=Yes
contratualmente	contratualmente	_
contundente	contundentemente	Abbr=Yes
contundentemente	contundentemente	_
convencional	convencionalmente	Abbr=Yes
convencionalista	convencionalistamente	Abbr=Yes
convencionalistamente	convencionalistamente	_
convencionalmente	convencionalmente	_
conveniente	convenientemente	Abbr=Yes
convenientemente	convenientemente	_
convergente	convergentemente	Abbr=Yes
convergentemente	convergentemente	_
convicta	convictamente	Abbr=Yes
convictamente	convictamente	_
convidativa	convidativamente	Abbr=Yes
convidativamente	convidativamente	_
convincente	convincentemente	Abbr=Yes
convincentemente	convincentemente	_
convulsiva	convulsivamente	Abbr=Yes
convulsivamente	convulsivamente	_
cooperativa	cooperativamente	Abbr=Yes
cooperativamente	cooperativamente	_
cooperativista	cooperativistamente	Abbr=Yes
cooperativistamente	cooperativistamente	_
cooperativisticamente	cooperativisticamente	_
coordenada	coordenadamente	Abbr=Yes
coordenadamente	coordenadamente	_
copiosa	copiosamente	Abbr=Yes
copiosamente	copiosamente	_
coquete	coquetemente	Abbr=Yes
coquetemente	coquetemente	_
corajosa	corajosamente	Abbr=Yes
corajosamente	corajosamente	_
cordial	cordialmente	Abbr=Yes
cordialmente	cordialmente	_
corporal	corporalmente	Abbr=Yes
corporalmente	corporalmente	_
corporativa	corporativamente	Abbr=Yes
corporativamente	corporativamente	_
corporativista	corporativistamente	Abbr=Yes
corporativistamente	corporativistamente	_
corporativisticamente	corporativisticamente	_
correlata	correlatamente	Abbr=Yes
correlatamente	correlatamente	_
correlativa	correlativamente	Abbr=Yes
correlativamente	correlativamente	_
corrente	correntemente	Abbr=Yes
correntemente	correntemente	_
correspondente	correspondentemente	Abbr=Yes
correspondentemente	correspondentemente	_
correta	corretamente	Abbr=Yes
corretamente	corretamente	_
corretiva	corretivamente	Abbr=Yes
corretivamente	corretivamente	_
corriqueira	corriqueiramente	Abbr=Yes
corriqueiramente	corriqueiramente	_
corruptora	corruptoramente	Abbr=Yes
corruptoramente	corruptoramente	_
cortes	cortesmente	Abbr=Yes
cortesmente	cortesmente	_
cosmetica	cosmeticamente	Abbr=Yes
cosmeticamente	cosmeticamente	_
cosmopolita	cosmopolitamente	Abbr=Yes
cosmopolitamente	cosmopolitamente	_
costumeira	costumeiramente	Abbr=Yes
costumeiramente	costumeiramente	_
cotidiana	cotidianamente	Abbr=Yes
cotidianamente	cotidianamente	_
covalente	covalentemente	Abbr=Yes
covalentemente	covalentemente	_
covarde	covardemente	Abbr=Yes
covardemente	covardemente	_
crescente	crescentemente	Abbr=Yes
crescentemente	crescentemente	_
cretina	cretinamente	Abbr=Yes
cretinamente	cretinamente	_
criativa	criativamente	Abbr=Yes
criativamente	criativamente	_
criminal	criminalmente	Abbr=Yes
criminalmente	criminalmente	_
criminosa	criminosamente	Abbr=Yes
criminosamente	criminosamente	_
cristalina	cristalinamente	Abbr=Yes
cristalinamente	cristalinamente	_
criteriosa	criteriosamente	Abbr=Yes
criteriosamente	criteriosamente	_
critica	criticamente	Abbr=Yes
criticamente	criticamente	_
crocodiliana	crocodilianamente	Abbr=Yes
crocodilianamente	crocodilianamente	_
cromatica	cromaticamente	Abbr=Yes
cromaticamente	cromaticamente	_
cromossomica	cromossomicamente	Abbr=Yes
cromossomicamente	cromossomicamente	_
cronica	cronicamente	Abbr=Yes
cronicamente	cronicamente	_
cronologica	cronologicamente	Abbr=Yes
cronologicamente	cronologicamente	_
crua	cruamente	Abbr=Yes
cruamente	cruamente	_
crucial	crucialmente	Abbr=Yes
crucialmente	crucialmente	_
cruel	cruelmente	Abbr=Yes
cruelmente	cruelmente	_
cruenta	cruentamente	Abbr=Yes
cruentamente	cruentamente	_
cubica	cubicamente	Abbr=Yes
cubicamente	cubicamente	_
cuidadosa	cuidadosamente	Abbr=Yes
cuidadosamente	cuidadosamente	_
culinaria	culinariamente	Abbr=Yes
culinariamente	culinariamente	_
culpavel	culpavelmente	Abbr=Yes
culpavelmente	culpavelmente	_
culposa	culposamente	Abbr=Yes
culposamente	culposamente	_
cultural	culturalmente	Abbr=Yes
culturalmente	culturalmente	_
cumulativa	cumulativamente	Abbr=Yes
cumulativamente	cumulativamente	_
cupida	cupidamente	Abbr=Yes
cupidamente	cupidamente	_
curiosa	curiosamente	Abbr=Yes
curiosamente	curiosamente	_
custosa	custosamente	Abbr=Yes
custosamente	custosamente	_
cá	cá	_
dantes	dantes	_
dantesca	dantescamente	Abbr=Yes
dantescamente	dantescamente	_
debaixo	debaixo	_
debil	debilmente	Abbr=Yes
debilitante	debilitantemente	Abbr=Yes
debilitantemente	debilitantemente	_
debilmente	debilmente	_
decadente	decadentemente	Abbr=Yes
decadentemente	decadentemente	_
decenal	decenalmente	Abbr=Yes
decenalmente	decenalmente	_
decente	decentemente	Abbr=Yes
decentemente	decentemente	_
decerto	decerto	_
decidida	decididamente	Abbr=Yes
decididamente	decididamente	_
decisiva	decisivamente	Abbr=Yes
decisivamente	decisivamente	_
declarada	declaradamente	Abbr=Yes
declaradamente	declaradamente	_
decorativa	decorativamente	Abbr=Yes
decorativamente	decorativamente	_
decrescente	decrescentemente	Abbr=Yes
decrescentemente	decrescentemente	_
dedicada	dedicadamente	Abbr=Yes
dedicadamente	dedicadamente	_
dedutiva	dedutivamente	Abbr=Yes
dedutivamente	dedutivamente	_
defensiva	defensivamente	Abbr=Yes
defensivamente	defensivamente	_
deficiente	deficientemente	Abbr=Yes
deficientemente	deficientemente	_
definitiva	definitivamente	Abbr=Yes
definitivamente	definitivamente	_
defronte	defronte	_
degradada	degradadamente	Abbr=Yes
degradadamente	degradadamente	_
deliberada	deliberadamente	Abbr=Yes
deliberadamente	deliberadamente	_
deliberante	deliberantemente	Abbr=Yes
deliberantemente	deliberantemente	_
deliberativa	deliberativamente	Abbr=Yes
deliberativamente	deliberativamente	_
delicada	delicadamente	Abbr=Yes
delicadamente	delicadamente	_
deliciosa	deliciosamente	Abbr=Yes
deliciosamente	deliciosamente	_
delirante	delirantemente	Abbr=Yes
delirantemente	delirantemente	_
demagogica	demagogicamente	Abbr=Yes
demagogicamente	demagogicamente	_
demais	demais	_
demasiada	demasiadamente	Abbr=Yes
demasiadamente	demasiadamente	_
demasiado	demasiado	_
democrata	democratamente	Abbr=Yes
democratamente	democratamente	_
democratica	democraticamente	Abbr=Yes
democraticamente	democraticamente	_
demografica	demograficamente	Abbr=Yes
demograficamente	demograficamente	_
demolidora	demolidoramente	Abbr=Yes
demolidoramente	demolidoramente	_
demonstrativa	demonstrativamente	Abbr=Yes
demonstrativamente	demonstrativamente	_
demonstravel	demonstravelmente	Abbr=Yes
demonstravelmente	demonstravelmente	_
demorada	demoradamente	Abbr=Yes
demoradamente	demoradamente	_
dengosa	dengosamente	Abbr=Yes
dengosamente	dengosamente	_
denodada	denodadamente	Abbr=Yes
denodadamente	denodadamente	_
denominativa	denominativamente	Abbr=Yes
denominativamente	denominativamente	_
densa	densamente	Abbr=Yes
densamente	densamente	_
dentro	dentro	_
denunciadora	denunciadoramente	Abbr=Yes
denunciadoramente	denunciadoramente	_
dependente	dependentemente	Abbr=Yes
dependentemente	dependentemente	_
deploravel	deploravelmente	Abbr=Yes
deploravelmente	deploravelmente	_
depois	depois	_
deprecavel	deprecavelmente	Abbr=Yes
deprecavelmente	deprecavelmente	_
depreciativa	depreciativamente	Abbr=Yes
depreciativamente	depreciativamente	_
depressa	depressa	_
depressiva	depressivamente	Abbr=Yes
depressivamente	depressivamente	_
deprimente	deprimentemente	Abbr=Yes
deprimentemente	deprimentemente	_
depurada	depuradamente	Abbr=Yes
depuradamente	depuradamente	_
desabalada	desabaladamente	Abbr=Yes
desabaladamente	desabaladamente	_
desabrida	desabridamente	Abbr=Yes
desabridamente	desabridamente	_
desacertada	desacertadamente	Abbr=Yes
desacertadamente	desacertadamente	_
desafiadora	desafiadoramente	Abbr=Yes
desafiadoramente	desafiadoramente	_
desaforada	desaforadamente	Abbr=Yes
desaforadamente	desaforadamente	_
desafortunada	desafortunadamente	Abbr=Yes
desafortunadamente	desafortunadamente	_
desagradavel	desagradavelmente	Abbr=Yes
desagradavelmente	desagradavelmente	_
desamparada	desamparadamente	Abbr=Yes
desamparadamente	desamparadamente	_
desapropriada	desapropriadamente	Abbr=Yes
desapropriadamente	desapropriadamente	_
desarticulada	desarticuladamente	Abbr=Yes
desarticuladamente	desarticuladamente	_
desastrada	desastradamente	Abbr=Yes
desastradamente	desastradamente	_
desastrosa	desastrosamente	Abbr=Yes
desastrosamente	desastrosamente	_
desbragada	desbragadamente	Abbr=Yes
desbragadamente	desbragadamente	_
descabida	descabidamente	Abbr=Yes
descabidamente	descabidamente	_
descansada	descansadamente	Abbr=Yes
descansadamente	descansadamente	_
descendente	descendentemente	Abbr=Yes
descendentemente	descendentemente	_
descente	descentemente	Abbr=Yes
descentemente	descentemente	_
descoberta	descobertamente	Abbr=Yes
descobertamente	descobertamente	_
desconcertante	desconcertantemente	Abbr=Yes
desconcertantemente	desconcertantemente	_
desconfortavel	desconfortavelmente	Abbr=Yes
desconfortavelmente	desconfortavelmente	_
desconsolada	desconsoladamente	Abbr=Yes
desconsoladamente	desconsoladamente	_
descontente	descontentemente	Abbr=Yes
descontentemente	descontentemente	_
descontinua	descontinuamente	Abbr=Yes
descontinuamente	descontinuamente	_
descontrolada	descontroladamente	Abbr=Yes
descontroladamente	descontroladamente	_
descritiva	descritivamente	Abbr=Yes
descritivamente	descritivamente	_
descuidada	descuidadamente	Abbr=Yes
descuidadamente	descuidadamente	_
desdenhadora	desdenhadoramente	Abbr=Yes
desdenhadoramente	desdenhadoramente	_
desdenhosa	desdenhosamente	Abbr=Yes
desdenhosamente	desdenhosamente	_
desditosa	desditosamente	Abbr=Yes
desditosamente	desditosamente	_
desejadora	desejadoramente	Abbr=Yes
desejadoramente	desejadoramente	_
desejavel	desejavelmente	Abbr=Yes
desejavelmente	desejavelmente	_
desejosa	desejosamente	Abbr=Yes
desejosamente	desejosamente	_
deselegante	deselegantemente	Abbr=Yes
deselegantemente	deselegantemente	_
desesperada	desesperadamente	Abbr=Yes
desesperadamente	desesperadamente	_
desfavoravel	desfavoravelmente	Abbr=Yes
desfavoravelmente	desfavoravelmente	_
desfrutadora	desfrutadoramente	Abbr=Yes
desfrutadoramente	desfrutadoramente	_
desfrutavel	desfrutavelmente	Abbr=Yes
desfrutavelmente	desfrutavelmente	_
desgastante	desgastantemente	Abbr=Yes
desgastantemente	desgastantemente	_
desgraçada	desgraçadamente	Abbr=Yes
desgraçadamente	desgraçadamente	_
desiderativa	desiderativamente	Abbr=Yes
desiderativamente	desiderativamente	_
designada	designadamente	Abbr=Yes
designadamente	designadamente	_
desigual	desigualmente	Abbr=Yes
desigualmente	desigualmente	_
desinteressada	desinteressadamente	Abbr=Yes
desinteressadamente	desinteressadamente	_
deslavada	deslavadamente	Abbr=Yes
deslavadamente	deslavadamente	_
desleal	deslealmente	Abbr=Yes
deslealmente	deslealmente	_
deslumbradoramente	deslumbradoramente	_
deslumbrante	deslumbrantemente	Abbr=Yes
deslumbrantemente	deslumbrantemente	_
desnecessaria	desnecessariamente	Abbr=Yes
desnecessariamente	desnecessariamente	_
desobediente	desobedientemente	Abbr=Yes
desobedientemente	desobedientemente	_
desolada	desoladamente	Abbr=Yes
desoladamente	desoladamente	_
desoladora	desoladoramente	Abbr=Yes
desoladoramente	desoladoramente	_
desonesta	desonestamente	Abbr=Yes
desonestamente	desonestamente	_
desopilante	desopilantemente	Abbr=Yes
desopilantemente	desopilantemente	_
desordenada	desordenadamente	Abbr=Yes
desordenadamente	desordenadamente	_
despachada	despachadamente	Abbr=Yes
despachadamente	despachadamente	_
despercebida	despercebidamente	Abbr=Yes
despercebidamente	despercebidamente	_
despota	despotamente	Abbr=Yes
despotamente	despotamente	_
despotica	despoticamente	Abbr=Yes
despoticamente	despoticamente	_
despreocupada	despreocupadamente	Abbr=Yes
despreocupadamente	despreocupadamente	_
despretensiosa	despretensiosamente	Abbr=Yes
despretensiosamente	despretensiosamente	_
desprevenida	desprevenidamente	Abbr=Yes
desprevenidamente	desprevenidamente	_
desproporcional	desproporcionalmente	Abbr=Yes
desproporcionalmente	desproporcionalmente	_
despudorada	despudoradamente	Abbr=Yes
despudoradamente	despudoradamente	_
destacada	destacadamente	Abbr=Yes
destacadamente	destacadamente	_
destarte	destarte	_
destemida	destemidamente	Abbr=Yes
destemidamente	destemidamente	_
destrutiva	destrutivamente	Abbr=Yes
destrutivamente	destrutivamente	_
desumana	desumanamente	Abbr=Yes
desumanamente	desumanamente	_
desvairada	desvairadamente	Abbr=Yes
desvairadamente	desvairadamente	_
desvairadora	desvairadoramente	Abbr=Yes
desvairadoramente	desvairadoramente	_
detalhada	detalhadamente	Abbr=Yes
detalhadamente	detalhadamente	_
deteriorante	deteriorantemente	Abbr=Yes
deteriorantemente	deteriorantemente	_
determinante	determinantemente	Abbr=Yes
determinantemente	determinantemente	_
determinativa	determinativamente	Abbr=Yes
determinativamente	determinativamente	_
detida	detidamente	Abbr=Yes
detidamente	detidamente	_
detrás	detrás	_
devagar	devagar	_
devassa	devassamente	Abbr=Yes
devassada	devassadamente	Abbr=Yes
devassadamente	devassadamente	_
devassadora	devassadoramente	Abbr=Yes
devassadoramente	devassadoramente	_
devassamente	devassamente	_
devastadora	devastadoramente	Abbr=Yes
devastadoramente	devastadoramente	_
deveras	deveras	_
devida	devidamente	Abbr=Yes
devidamente	devidamente	_
devota	devotamente	Abbr=Yes
devotada	devotadamente	Abbr=Yes
devotadamente	devotadamente	_
devotamente	devotamente	_
diabolica	diabolicamente	Abbr=Yes
diabolicamente	diabolicamente	_
diagnostica	diagnosticamente	Abbr=Yes
diagnosticamente	diagnosticamente	_
diagonal	diagonalmente	Abbr=Yes
diagonalmente	diagonalmente	_
dialetal	dialetalmente	Abbr=Yes
dialetalmente	dialetalmente	_
dialetica	dialeticamente	Abbr=Yes
dialeticamente	dialeticamente	_
diametral	diametralmente	Abbr=Yes
diametralmente	diametralmente	_
diante	diante	_
diaria	diariamente	Abbr=Yes
diariamente	diariamente	_
didatica	didaticamente	Abbr=Yes
didaticamente	didaticamente	_
dietetica	dieteticamente	Abbr=Yes
dieteticamente	dieteticamente	_
diferencial	diferencialmente	Abbr=Yes
diferencialmente	diferencialmente	_
diferente	diferentemente	Abbr=Yes
diferentemente	diferentemente	_
dificil	dificilmente	Abbr=Yes
dificilmente	dificilmente	_
difusa	difusamente	Abbr=Yes
difusamente	difusamente	_
difícil	difícil	_
digital	digitalmente	Abbr=Yes
digitalmente	digitalmente	_
digna	dignamente	Abbr=Yes
dignamente	dignamente	_
digressiva	digressivamente	Abbr=Yes
digressivamente	digressivamente	_
diletante	diletantemente	Abbr=Yes
diletantemente	diletantemente	_
diligente	diligentemente	Abbr=Yes
diligentemente	diligentemente	_
dinamica	dinamicamente	Abbr=Yes
dinamicamente	dinamicamente	_
dionisiaca	dionisiacamente	Abbr=Yes
dionisiacamente	dionisiacamente	_
diplomatica	diplomaticamente	Abbr=Yes
diplomaticamente	diplomaticamente	_
direito	direito	_
direta	diretamente	Abbr=Yes
diretamente	diretamente	_
direto	direto	_
disciplinada	disciplinadamente	Abbr=Yes
disciplinadamente	disciplinadamente	_
disciplinar	disciplinarmente	Abbr=Yes
disciplinarmente	disciplinarmente	_
discreta	discretamente	Abbr=Yes
discretamente	discretamente	_
discricionaria	discricionariamente	Abbr=Yes
discricionariamente	discricionariamente	_
discriminada	discriminadamente	Abbr=Yes
discriminadamente	discriminadamente	_
discursiva	discursivamente	Abbr=Yes
discursivamente	discursivamente	_
discutivel	discutivelmente	Abbr=Yes
discutivelmente	discutivelmente	_
disfarçada	disfarçadamente	Abbr=Yes
disfarçadamente	disfarçadamente	_
displicente	displicentemente	Abbr=Yes
displicentemente	displicentemente	_
dissimulada	dissimuladamente	Abbr=Yes
dissimuladamente	dissimuladamente	_
dissolvente	dissolventemente	Abbr=Yes
dissolventemente	dissolventemente	_
dissuasiva	dissuasivamente	Abbr=Yes
dissuasivamente	dissuasivamente	_
distanciada	distanciadamente	Abbr=Yes
distanciadamente	distanciadamente	_
distante	distante	_
distinta	distintamente	Abbr=Yes
distintamente	distintamente	_
distintiva	distintivamente	Abbr=Yes
distintivamente	distintivamente	_
distraida	distraidamente	Abbr=Yes
distraidamente	distraidamente	_
distributiva	distributivamente	Abbr=Yes
distributivamente	distributivamente	_
diuturna	diuturnamente	Abbr=Yes
diuturnamente	diuturnamente	_
diversa	diversamente	Abbr=Yes
diversamente	diversamente	_
divertida	divertidamente	Abbr=Yes
divertidamente	divertidamente	_
divina	divinamente	Abbr=Yes
divinamente	divinamente	_
doce	docemente	Abbr=Yes
docemente	docemente	_
docil	docilmente	Abbr=Yes
docilmente	docilmente	_
documentada	documentadamente	Abbr=Yes
documentadamente	documentadamente	_
documental	documentalmente	Abbr=Yes
documentalmente	documentalmente	_
doentia	doentiamente	Abbr=Yes
doentiamente	doentiamente	_
dogmatica	dogmaticamente	Abbr=Yes
dogmaticamente	dogmaticamente	_
doida	doidamente	Abbr=Yes
doidamente	doidamente	_
dolorida	doloridamente	Abbr=Yes
doloridamente	doloridamente	_
dolorosa	dolorosamente	Abbr=Yes
dolorosamente	dolorosamente	_
dolosa	dolosamente	Abbr=Yes
dolosamente	dolosamente	_
domestica	domesticamente	Abbr=Yes
domesticamente	domesticamente	_
dominante	dominantemente	Abbr=Yes
dominantemente	dominantemente	_
dominical	dominicalmente	Abbr=Yes
dominicalmente	dominicalmente	_
doravante	doravante	_
dorsal	dorsalmente	Abbr=Yes
dorsalmente	dorsalmente	_
doutrinaria	doutrinariamente	Abbr=Yes
doutrinariamente	doutrinariamente	_
dramatica	dramaticamente	Abbr=Yes
dramaticamente	dramaticamente	_
drastica	drasticamente	Abbr=Yes
drasticamente	drasticamente	_
dualista	dualistamente	Abbr=Yes
dualistamente	dualistamente	_
ductil	ductilmente	Abbr=Yes
ductilmente	ductilmente	_
dupla	duplamente	Abbr=Yes
duplamente	duplamente	_
duplicada	duplicadamente	Abbr=Yes
duplicadamente	duplicadamente	_
dura	duramente	Abbr=Yes
duradoura	duradouramente	Abbr=Yes
duradouramente	duradouramente	_
duramente	duramente	_
duravel	duravelmente	Abbr=Yes
duravelmente	duravelmente	_
duvidosa	duvidosamente	Abbr=Yes
duvidosamente	duvidosamente	_
eclesiastica	eclesiasticamente	Abbr=Yes
eclesiasticamente	eclesiasticamente	_
ecologica	ecologicamente	Abbr=Yes
ecologicamente	ecologicamente	_
economica	economicamente	Abbr=Yes
economicamente	economicamente	_
edital	editalmente	Abbr=Yes
editalmente	editalmente	_
editorial	editorialmente	Abbr=Yes
editorialmente	editorialmente	_
educacional	educacionalmente	Abbr=Yes
educacionalmente	educacionalmente	_
educada	educadamente	Abbr=Yes
educadamente	educadamente	_
efetiva	efetivamente	Abbr=Yes
efetivamente	efetivamente	_
eficaz	eficazmente	Abbr=Yes
eficazmente	eficazmente	_
eficiente	eficientemente	Abbr=Yes
eficientemente	eficientemente	_
efusiva	efusivamente	Abbr=Yes
efusivamente	efusivamente	_
egoistica	egoisticamente	Abbr=Yes
egoisticamente	egoisticamente	_
eis	eis	_
elastica	elasticamente	Abbr=Yes
elasticamente	elasticamente	_
elegante	elegantemente	Abbr=Yes
elegantemente	elegantemente	_
eleitoral	eleitoralmente	Abbr=Yes
eleitoralmente	eleitoralmente	_
eleitoreira	eleitoreiramente	Abbr=Yes
eleitoreiramente	eleitoreiramente	_
eletrica	eletricamente	Abbr=Yes
eletricamente	eletricamente	_
eletromagnetica	eletromagneticamente	Abbr=Yes
eletromagneticamente	eletromagneticamente	_
eletronica	eletronicamente	Abbr=Yes
eletronicamente	eletronicamente	_
eletroquimica	eletroquimicamente	Abbr=Yes
eletroquimicamente	eletroquimicamente	_
eletrostatica	eletrostaticamente	Abbr=Yes
eletrostaticamente	eletrostaticamente	_
eliptica	elipticamente	Abbr=Yes
elipticamente	elipticamente	_
eloquente	eloquentemente	Abbr=Yes
eloquentemente	eloquentemente	_
embaixo	embaixo	_
embaraçosa	embaraçosamente	Abbr=Yes
embaraçosamente	embaraçosamente	_
emblematica	emblematicamente	Abbr=Yes
emblematicamente	emblematicamente	_
embora	embora	_
embrionaria	embrionariamente	Abbr=Yes
embrionariamente	embrionariamente	_
emergencial	emergencialmente	Abbr=Yes
emergencialmente	emergencialmente	_
eminente	eminentemente	Abbr=Yes
eminentemente	eminentemente	_
emocionada	emocionadamente	Abbr=Yes
emocionadamente	emocionadamente	_
emocional	emocionalmente	Abbr=Yes
emocionalmente	emocionalmente	_
emocionante	emocionantemente	Abbr=Yes
emocionantemente	emocionantemente	_
emotiva	emotivamente	Abbr=Yes
emotivamente	emotivamente	_
empirica	empiricamente	Abbr=Yes
empiricamente	empiricamente	_
empresarial	empresarialmente	Abbr=Yes
empresarialmente	empresarialmente	_
encantadora	encantadoramente	Abbr=Yes
encantadoramente	encantadoramente	_
endemica	endemicamente	Abbr=Yes
endemicamente	endemicamente	_
endogena	endogenamente	Abbr=Yes
endogenamente	endogenamente	_
energetica	energeticamente	Abbr=Yes
energeticamente	energeticamente	_
energica	energicamente	Abbr=Yes
energicamente	energicamente	_
enfadonha	enfadonhamente	Abbr=Yes
enfadonhamente	enfadonhamente	_
enfatica	enfaticamente	Abbr=Yes
enfaticamente	enfaticamente	_
enfim	enfim	_
enforcada	enforcadamente	Abbr=Yes
enforcadamente	enforcadamente	_
enganosa	enganosamente	Abbr=Yes
enganosamente	enganosamente	_
engasgada	engasgadamente	Abbr=Yes
engasgadamente	engasgadamente	_
engenhosa	engenhosamente	Abbr=Yes
engenhosamente	engenhosamente	_
enigmatica	enigmaticamente	Abbr=Yes
enigmaticamente	enigmaticamente	_
enjoativa	enjoativamente	Abbr=Yes
enjoativamente	enjoativamente	_
enorme	enormemente	Abbr=Yes
enormemente	enormemente	_
enquanto	enquanto	_
enrolada	enroladamente	Abbr=Yes
enroladamente	enroladamente	_
ensopada	ensopadamente	Abbr=Yes
ensopadamente	ensopadamente	_
enternecida	enternecidamente	Abbr=Yes
enternecidamente	enternecidamente	_
enternecivel	enternecivelmente	Abbr=Yes
enternecivelmente	enternecivelmente	_
entrada	entradamente	Abbr=Yes
entradamente	entradamente	_
entranhada	entranhadamente	Abbr=Yes
entranhadamente	entranhadamente	_
entrementes	entrementes	_
entropica	entropicamente	Abbr=Yes
entropicamente	entropicamente	_
entusiasmada	entusiasmadamente	Abbr=Yes
entusiasmadamente	entusiasmadamente	_
entusiastica	entusiasticamente	Abbr=Yes
entusiasticamente	entusiasticamente	_
então	então	_
epica	epicamente	Abbr=Yes
epicamente	epicamente	_
epidermica	epidermicamente	Abbr=Yes
epidermicamente	epidermicamente	_
epigramatica	epigramaticamente	Abbr=Yes
epigramaticamente	epigramaticamente	_
episodica	episodicamente	Abbr=Yes
episodicamente	episodicamente	_
epistemologica	epistemologicamente	Abbr=Yes
epistemologicamente	epistemologicamente	_
equani	equanimente	Abbr=Yes
equanimente	equanimente	_
equilibrada	equilibradamente	Abbr=Yes
equilibradamente	equilibradamente	_
equitativa	equitativamente	Abbr=Yes
equitativamente	equitativamente	_
equivalente	equivalentemente	Abbr=Yes
equivalentemente	equivalentemente	_
equivocada	equivocadamente	Abbr=Yes
equivocadamente	equivocadamente	_
erotica	eroticamente	Abbr=Yes
eroticamente	eroticamente	_
errada	erradamente	Abbr=Yes
erradamente	erradamente	_
errante	errantemente	Abbr=Yes
errantemente	errantemente	_
erratica	erraticamente	Abbr=Yes
erraticamente	erraticamente	_
erronea	erroneamente	Abbr=Yes
erroneamente	erroneamente	_
escancarada	escancaradamente	Abbr=Yes
escancaradamente	escancaradamente	_
escandalosa	escandalosamente	Abbr=Yes
escandalosamente	escandalosamente	_
escassa	escassamente	Abbr=Yes
escassamente	escassamente	_
escolar	escolarmente	Abbr=Yes
escolarmente	escolarmente	_
escrupulosa	escrupulosamente	Abbr=Yes
escrupulosamente	escrupulosamente	_
escusada	escusadamente	Abbr=Yes
escusadamente	escusadamente	_
esdruxula	esdruxulamente	Abbr=Yes
esdruxulamente	esdruxulamente	_
esfuziante	esfuziantemente	Abbr=Yes
esfuziantemente	esfuziantemente	_
esmagadora	esmagadoramente	Abbr=Yes
esmagadoramente	esmagadoramente	_
esmerada	esmeradamente	Abbr=Yes
esmeradamente	esmeradamente	_
esnobe	esnobemente	Abbr=Yes
esnobemente	esnobemente	_
espacial	espacialmente	Abbr=Yes
espacialmente	espacialmente	_
espanhola	espanholamente	Abbr=Yes
espanholamente	espanholamente	_
espantosa	espantosamente	Abbr=Yes
espantosamente	espantosamente	_
esparsa	esparsamente	Abbr=Yes
esparsamente	esparsamente	_
espartana	espartanamente	Abbr=Yes
espartanamente	espartanamente	_
espasmodica	espasmodicamente	Abbr=Yes
espasmodicamente	espasmodicamente	_
espaçada	espaçadamente	Abbr=Yes
espaçadamente	espaçadamente	_
espaçosa	espaçosamente	Abbr=Yes
espaçosamente	espaçosamente	_
especial	especialmente	Abbr=Yes
especialmente	especialmente	_
especifica	especificamente	Abbr=Yes
especificada	especificadamente	Abbr=Yes
especificadamente	especificadamente	_
especificamente	especificamente	_
especular	especularmente	Abbr=Yes
especularmente	especularmente	_
especulativa	especulativamente	Abbr=Yes
especulativamente	especulativamente	_
esperançosa	esperançosamente	Abbr=Yes
esperançosamente	esperançosamente	_
esperta	espertamente	Abbr=Yes
espertalhona	espertalhonamente	Abbr=Yes
espertalhonamente	espertalhonamente	_
espertamente	espertamente	_
espetacular	espetacularmente	Abbr=Yes
espetacularmente	espetacularmente	_
espirita	espiritamente	Abbr=Yes
espiritamente	espiritamente	_
espiritual	espiritualmente	Abbr=Yes
espiritualista	espiritualistamente	Abbr=Yes
espiritualistamente	espiritualistamente	_
espiritualmente	espiritualmente	_
espirituosa	espirituosamente	Abbr=Yes
espirituosamente	espirituosamente	_
esplendida	esplendidamente	Abbr=Yes
esplendidamente	esplendidamente	_
espontanea	espontaneamente	Abbr=Yes
espontaneamente	espontaneamente	_
esporadica	esporadicamente	Abbr=Yes
esporadicamente	esporadicamente	_
esportiva	esportivamente	Abbr=Yes
esportivamente	esportivamente	_
esquematica	esquematicamente	Abbr=Yes
esquematicamente	esquematicamente	_
esquiva	esquivamente	Abbr=Yes
esquivamente	esquivamente	_
esquizofrenica	esquizofrenicamente	Abbr=Yes
esquizofrenicamente	esquizofrenicamente	_
essencial	essencialmente	Abbr=Yes
essencialmente	essencialmente	_
estatica	estaticamente	Abbr=Yes
estaticamente	estaticamente	_
estatistica	estatisticamente	Abbr=Yes
estatisticamente	estatisticamente	_
estatuaria	estatuariamente	Abbr=Yes
estatuariamente	estatuariamente	_
estatutaria	estatutariamente	Abbr=Yes
estatutariamente	estatutariamente	_
estavel	estavelmente	Abbr=Yes
estavelmente	estavelmente	_
estetica	esteticamente	Abbr=Yes
esteticamente	esteticamente	_
estigmatica	estigmaticamente	Abbr=Yes
estigmaticamente	estigmaticamente	_
estilistica	estilisticamente	Abbr=Yes
estilisticamente	estilisticamente	_
estimativa	estimativamente	Abbr=Yes
estimativamente	estimativamente	_
estimulante	estimulantemente	Abbr=Yes
estimulantemente	estimulantemente	_
estoica	estoicamente	Abbr=Yes
estoicamente	estoicamente	_
estonteante	estonteantemente	Abbr=Yes
estonteantemente	estonteantemente	_
estouvada	estouvadamente	Abbr=Yes
estouvadamente	estouvadamente	_
estranha	estranhamente	Abbr=Yes
estranhamente	estranhamente	_
estrategica	estrategicamente	Abbr=Yes
estrategicamente	estrategicamente	_
estratosferica	estratosfericamente	Abbr=Yes
estratosfericamente	estratosfericamente	_
estreita	estreitamente	Abbr=Yes
estreitamente	estreitamente	_
estrepitosa	estrepitosamente	Abbr=Yes
estrepitosamente	estrepitosamente	_
estridulante	estridulantemente	Abbr=Yes
estridulantemente	estridulantemente	_
estrita	estritamente	Abbr=Yes
estritamente	estritamente	_
estrondosa	estrondosamente	Abbr=Yes
estrondosamente	estrondosamente	_
estrutural	estruturalmente	Abbr=Yes
estruturalmente	estruturalmente	_
estudiosa	estudiosamente	Abbr=Yes
estudiosamente	estudiosamente	_
estupida	estupidamente	Abbr=Yes
estupidamente	estupidamente	_
eterna	eternamente	Abbr=Yes
eternamente	eternamente	_
etica	eticamente	Abbr=Yes
eticamente	eticamente	_
etimologica	etimologicamente	Abbr=Yes
etimologicamente	etimologicamente	_
etnica	etnicamente	Abbr=Yes
etnicamente	etnicamente	_
etnologica	etnologicamente	Abbr=Yes
etnologicamente	etnologicamente	_
euforica	euforicamente	Abbr=Yes
euforicamente	euforicamente	_
europeia	europeiamente	Abbr=Yes
europeiamente	europeiamente	_
evangelica	evangelicamente	Abbr=Yes
evangelicamente	evangelicamente	_
evasiva	evasivamente	Abbr=Yes
evasivamente	evasivamente	_
eventual	eventualmente	Abbr=Yes
eventualmente	eventualmente	_
evidente	evidentemente	Abbr=Yes
evidentemente	evidentemente	_
evolutiva	evolutivamente	Abbr=Yes
evolutivamente	evolutivamente	_
exacerbada	exacerbadamente	Abbr=Yes
exacerbadamente	exacerbadamente	_
exagerada	exageradamente	Abbr=Yes
exageradamente	exageradamente	_
exata	exatamente	Abbr=Yes
exatamente	exatamente	_
exaustiva	exaustivamente	Abbr=Yes
exaustivamente	exaustivamente	_
excelente	excelentemente	Abbr=Yes
excelentemente	excelentemente	_
excentrica	excentricamente	Abbr=Yes
excentricamente	excentricamente	_
excepcional	excepcionalmente	Abbr=Yes
excepcionalmente	excepcionalmente	_
excessiva	excessivamente	Abbr=Yes
excessivamente	excessivamente	_
exclamativa	exclamativamente	Abbr=Yes
exclamativamente	exclamativamente	_
exclusiva	exclusivamente	Abbr=Yes
exclusivamente	exclusivamente	_
exclusive	exclusive	_
exclusivista	exclusivistamente	Abbr=Yes
exclusivistamente	exclusivistamente	_
exegetica	exegeticamente	Abbr=Yes
exegeticamente	exegeticamente	_
exemplar	exemplarmente	Abbr=Yes
exemplarmente	exemplarmente	_
exemplificativa	exemplificativamente	Abbr=Yes
exemplificativamente	exemplificativamente	_
exibicionista	exibicionistamente	Abbr=Yes
exibicionistamente	exibicionistamente	_
eximia	eximiamente	Abbr=Yes
eximiamente	eximiamente	_
existencial	existencialmente	Abbr=Yes
existencialmente	existencialmente	_
exotica	exoticamente	Abbr=Yes
exoticamente	exoticamente	_
experiente	experientemente	Abbr=Yes
experientemente	experientemente	_
experimentadora	experimentadoramente	Abbr=Yes
experimentadoramente	experimentadoramente	_
experimental	experimentalmente	Abbr=Yes
experimentalmente	experimentalmente	_
expletiva	expletivamente	Abbr=Yes
expletivamente	expletivamente	_
explicita	explicitamente	Abbr=Yes
explicitamente	explicitamente	_
explosiva	explosivamente	Abbr=Yes
explosivamente	explosivamente	_
exponencial	exponencialmente	Abbr=Yes
exponencialmente	exponencialmente	_
exposta	expostamente	Abbr=Yes
expostamente	expostamente	_
expressa	expressamente	Abbr=Yes
expressamente	expressamente	_
expressionista	expressionistamente	Abbr=Yes
expressionistamente	expressionistamente	_
expressiva	expressivamente	Abbr=Yes
expressivamente	expressivamente	_
extensa	extensamente	Abbr=Yes
extensamente	extensamente	_
extensiva	extensivamente	Abbr=Yes
extensivamente	extensivamente	_
exterior	exteriormente	Abbr=Yes
exteriormente	exteriormente	_
externa	externamente	Abbr=Yes
externamente	externamente	_
extracelular	extracelularmente	Abbr=Yes
extracelularmente	extracelularmente	_
extraditada	extraditadamente	Abbr=Yes
extraditadamente	extraditadamente	_
extrajudicial	extrajudicialmente	Abbr=Yes
extrajudicialmente	extrajudicialmente	_
extraordinaria	extraordinariamente	Abbr=Yes
extraordinariamente	extraordinariamente	_
extravagante	extravagantemente	Abbr=Yes
extravagantemente	extravagantemente	_
extrema	extremamente	Abbr=Yes
extremamente	extremamente	_
extremista	extremistamente	Abbr=Yes
extremistamente	extremistamente	_
extremosa	extremosamente	Abbr=Yes
extremosamente	extremosamente	_
extrinseca	extrinsecamente	Abbr=Yes
extrinsecamente	extrinsecamente	_
exuberante	exuberantemente	Abbr=Yes
exuberantemente	exuberantemente	_
fabulosa	fabulosamente	Abbr=Yes
fabulosamente	fabulosamente	_
faceira	faceiramente	Abbr=Yes
faceiramente	faceiramente	_
facial	facialmente	Abbr=Yes
facialmente	facialmente	_
facil	facilmente	Abbr=Yes
facilmente	facilmente	_
factual	factualmente	Abbr=Yes
factualmente	factualmente	_
facultativa	facultativamente	Abbr=Yes
facultativamente	facultativamente	_
falaciosa	falaciosamente	Abbr=Yes
falaciosamente	falaciosamente	_
falsa	falsamente	Abbr=Yes
falsamente	falsamente	_
falsificadora	falsificadoramente	Abbr=Yes
falsificadoramente	falsificadoramente	_
faltosa	faltosamente	Abbr=Yes
faltosamente	faltosamente	_
familiar	familiarmente	Abbr=Yes
familiarmente	familiarmente	_
famosa	famosamente	Abbr=Yes
famosamente	famosamente	_
fanatica	fanaticamente	Abbr=Yes
fanaticamente	fanaticamente	_
fanfarrona	fanfarronamente	Abbr=Yes
fanfarronamente	fanfarronamente	_
fantasmagorica	fantasmagoricamente	Abbr=Yes
fantasmagoricamente	fantasmagoricamente	_
fantastica	fantasticamente	Abbr=Yes
fantasticamente	fantasticamente	_
farfalhosamente	farfalhosamente	_
farmacodinamica	farmacodinamicamente	Abbr=Yes
farmacodinamicamente	farmacodinamicamente	_
farmacologica	farmacologicamente	Abbr=Yes
farmacologicamente	farmacologicamente	_
farmacotecnica	farmacotecnicamente	Abbr=Yes
farmacotecnicamente	farmacotecnicamente	_
farta	fartamente	Abbr=Yes
fartamente	fartamente	_
fascinante	fascinantemente	Abbr=Yes
fascinantemente	fascinantemente	_
fascista	fascistamente	Abbr=Yes
fascistamente	fascistamente	_
fastidiosa	fastidiosamente	Abbr=Yes
fastidiosamente	fastidiosamente	_
fatal	fatalmente	Abbr=Yes
fatalista	fatalistamente	Abbr=Yes
fatalistamente	fatalistamente	_
fatalmente	fatalmente	_
fatidica	fatidicamente	Abbr=Yes
fatidicamente	fatidicamente	_
favoravel	favoravelmente	Abbr=Yes
favoravelmente	favoravelmente	_
febril	febrilmente	Abbr=Yes
febrilmente	febrilmente	_
fecunda	fecundamente	Abbr=Yes
fecundamente	fecundamente	_
federativa	federativamente	Abbr=Yes
federativamente	federativamente	_
felina	felinamente	Abbr=Yes
felinamente	felinamente	_
feliz	felizmente	Abbr=Yes
felizmente	felizmente	_
feminina	femininamente	Abbr=Yes
femininamente	femininamente	_
fenomenal	fenomenalmente	Abbr=Yes
fenomenalmente	fenomenalmente	_
fenomenologica	fenomenologicamente	Abbr=Yes
fenomenologicamente	fenomenologicamente	_
feroz	ferozmente	Abbr=Yes
ferozmente	ferozmente	_
ferrea	ferreamente	Abbr=Yes
ferreamente	ferreamente	_
ferrenha	ferrenhamente	Abbr=Yes
ferrenhamente	ferrenhamente	_
fervorosa	fervorosamente	Abbr=Yes
fervorosamente	fervorosamente	_
festiva	festivamente	Abbr=Yes
festivamente	festivamente	_
fetichista	fetichistamente	Abbr=Yes
fetichistamente	fetichistamente	_
fiado	fiado	_
ficcional	ficcionalmente	Abbr=Yes
ficcionalmente	ficcionalmente	_
ficta	fictamente	Abbr=Yes
fictamente	fictamente	_
fiduciaria	fiduciariamente	Abbr=Yes
fiduciariamente	fiduciariamente	_
fiel	fielmente	Abbr=Yes
fielmente	fielmente	_
figurada	figuradamente	Abbr=Yes
figuradamente	figuradamente	_
figurativa	figurativamente	Abbr=Yes
figurativamente	figurativamente	_
filarmonica	filarmonicamente	Abbr=Yes
filarmonicamente	filarmonicamente	_
filial	filialmente	Abbr=Yes
filialmente	filialmente	_
filologica	filologicamente	Abbr=Yes
filologicamente	filologicamente	_
filosofal	filosofalmente	Abbr=Yes
filosofalmente	filosofalmente	_
filosofica	filosoficamente	Abbr=Yes
filosoficamente	filosoficamente	_
fina	finamente	Abbr=Yes
final	finalmente	Abbr=Yes
finalmente	finalmente	_
finamente	finamente	_
financeira	financeiramente	Abbr=Yes
financeiramente	financeiramente	_
fino	fino	_
firme	firme	_
firme	firmemente	Abbr=Yes
firmemente	firmemente	_
fiscal	fiscalmente	Abbr=Yes
fiscalmente	fiscalmente	_
fisica	fisicamente	Abbr=Yes
fisicamente	fisicamente	_
fisiologica	fisiologicamente	Abbr=Yes
fisiologicamente	fisiologicamente	_
fitolacacea	fitolacaceamente	Abbr=Yes
fitolacaceamente	fitolacaceamente	_
fixa	fixamente	Abbr=Yes
fixamente	fixamente	_
flagrante	flagrantemente	Abbr=Yes
flagrantemente	flagrantemente	_
flexivel	flexivelmente	Abbr=Yes
flexivelmente	flexivelmente	_
fluente	fluentemente	Abbr=Yes
fluentemente	fluentemente	_
fluidica	fluidicamente	Abbr=Yes
fluidicamente	fluidicamente	_
fluvial	fluvialmente	Abbr=Yes
fluvialmente	fluvialmente	_
focal	focalmente	Abbr=Yes
focalmente	focalmente	_
folgada	folgadamente	Abbr=Yes
folgadamente	folgadamente	_
folgazona	folgazonamente	Abbr=Yes
folgazonamente	folgazonamente	_
fonetica	foneticamente	Abbr=Yes
foneticamente	foneticamente	_
fonica	fonicamente	Abbr=Yes
fonicamente	fonicamente	_
fora	fora	_
formal	formalmente	Abbr=Yes
formalista	formalistamente	Abbr=Yes
formalistamente	formalistamente	_
formalmente	formalmente	_
formidavel	formidavelmente	Abbr=Yes
formidavelmente	formidavelmente	_
forte	forte	_
forte	fortemente	Abbr=Yes
fortemente	fortemente	_
fortuita	fortuitamente	Abbr=Yes
fortuitamente	fortuitamente	_
forçada	forçadamente	Abbr=Yes
forçadamente	forçadamente	_
forçosa	forçosamente	Abbr=Yes
forçosamente	forçosamente	_
fosca	foscamente	Abbr=Yes
foscamente	foscamente	_
fotografica	fotograficamente	Abbr=Yes
fotograficamente	fotograficamente	_
fotoquimica	fotoquimicamente	Abbr=Yes
fotoquimicamente	fotoquimicamente	_
fraca	fracamente	Abbr=Yes
fracamente	fracamente	_
fragil	fragilmente	Abbr=Yes
fragilmente	fragilmente	_
fragmentaria	fragmentariamente	Abbr=Yes
fragmentariamente	fragmentariamente	_
fragorosa	fragorosamente	Abbr=Yes
fragorosamente	fragorosamente	_
franca	francamente	Abbr=Yes
francamente	francamente	_
frances	francesmente	Abbr=Yes
francesa	francesamente	Abbr=Yes
francesamente	francesamente	_
francesmente	francesmente	_
fraterna	fraternamente	Abbr=Yes
fraternal	fraternalmente	Abbr=Yes
fraternalmente	fraternalmente	_
fraternamente	fraternamente	_
fraudulenta	fraudulentamente	Abbr=Yes
fraudulentamente	fraudulentamente	_
fremente	frementemente	Abbr=Yes
frementemente	frementemente	_
frenetica	freneticamente	Abbr=Yes
freneticamente	freneticamente	_
frente	frente	_
frequente	frequentemente	Abbr=Yes
frequentemente	frequentemente	_
fresca	frescamente	Abbr=Yes
frescamente	frescamente	_
freudiana	freudianamente	Abbr=Yes
freudianamente	freudianamente	_
fria	friamente	Abbr=Yes
friamente	friamente	_
frigida	frigidamente	Abbr=Yes
frigidamente	frigidamente	_
frontal	frontalmente	Abbr=Yes
frontalmente	frontalmente	_
frouxa	frouxamente	Abbr=Yes
frouxamente	frouxamente	_
frugal	frugalmente	Abbr=Yes
frugalmente	frugalmente	_
fugaz	fugazmente	Abbr=Yes
fugazmente	fugazmente	_
fugidia	fugidiamente	Abbr=Yes
fugidiamente	fugidiamente	_
fulgurante	fulgurantemente	Abbr=Yes
fulgurantemente	fulgurantemente	_
fulminante	fulminantemente	Abbr=Yes
fulminantemente	fulminantemente	_
funcional	funcionalmente	Abbr=Yes
funcionalmente	funcionalmente	_
fundada	fundadamente	Abbr=Yes
fundadamente	fundadamente	_
fundamentada	fundamentadamente	Abbr=Yes
fundamentadamente	fundamentadamente	_
fundamental	fundamentalmente	Abbr=Yes
fundamentalmente	fundamentalmente	_
fundo	fundo	_
furiosa	furiosamente	Abbr=Yes
furiosamente	furiosamente	_
furtiva	furtivamente	Abbr=Yes
furtivamente	furtivamente	_
futebolistica	futebolisticamente	Abbr=Yes
futebolisticamente	futebolisticamente	_
futil	futilmente	Abbr=Yes
futilmente	futilmente	_
futura	futuramente	Abbr=Yes
futuramente	futuramente	_
futurista	futuristamente	Abbr=Yes
futuristamente	futuristamente	_
fácil	fácil	_
gaiata	gaiatamente	Abbr=Yes
gaiatamente	gaiatamente	_
galante	galantemente	Abbr=Yes
galantemente	galantemente	_
galharda	galhardamente	Abbr=Yes
galhardamente	galhardamente	_
galopante	galopantemente	Abbr=Yes
galopantemente	galopantemente	_
galvanoplastica	galvanoplasticamente	Abbr=Yes
galvanoplasticamente	galvanoplasticamente	_
gananciosa	gananciosamente	Abbr=Yes
gananciosamente	gananciosamente	_
garbosa	garbosamente	Abbr=Yes
garbosamente	garbosamente	_
gastronomica	gastronomicamente	Abbr=Yes
gastronomicamente	gastronomicamente	_
generalizada	generalizadamente	Abbr=Yes
generalizadamente	generalizadamente	_
generica	genericamente	Abbr=Yes
genericamente	genericamente	_
generosa	generosamente	Abbr=Yes
generosamente	generosamente	_
genetica	geneticamente	Abbr=Yes
geneticamente	geneticamente	_
genial	genialmente	Abbr=Yes
genialmente	genialmente	_
gentil	gentilmente	Abbr=Yes
gentilmente	gentilmente	_
genuina	genuinamente	Abbr=Yes
genuinamente	genuinamente	_
geodinamica	geodinamicamente	Abbr=Yes
geodinamicamente	geodinamicamente	_
geofisica	geofisicamente	Abbr=Yes
geofisicamente	geofisicamente	_
geografica	geograficamente	Abbr=Yes
geograficamente	geograficamente	_
geologica	geologicamente	Abbr=Yes
geologicamente	geologicamente	_
geometrica	geometricamente	Abbr=Yes
geometricamente	geometricamente	_
geopolitica	geopoliticamente	Abbr=Yes
geopoliticamente	geopoliticamente	_
geotectonica	geotectonicamente	Abbr=Yes
geotectonicamente	geotectonicamente	_
geral	geralmente	Abbr=Yes
geralmente	geralmente	_
gerativa	gerativamente	Abbr=Yes
gerativamente	gerativamente	_
gerencial	gerencialmente	Abbr=Yes
gerencialmente	gerencialmente	_
germana	germanamente	Abbr=Yes
germanamente	germanamente	_
germanica	germanicamente	Abbr=Yes
germanicamente	germanicamente	_
germanista	germanistamente	Abbr=Yes
germanistamente	germanistamente	_
germanistica	germanisticamente	Abbr=Yes
germanisticamente	germanisticamente	_
ginastica	ginasticamente	Abbr=Yes
ginasticamente	ginasticamente	_
glacial	glacialmente	Abbr=Yes
glacialmente	glacialmente	_
global	globalmente	Abbr=Yes
globalmente	globalmente	_
gloriosa	gloriosamente	Abbr=Yes
gloriosamente	gloriosamente	_
glutona	glutonamente	Abbr=Yes
glutonamente	glutonamente	_
gostosa	gostosamente	Abbr=Yes
gostosamente	gostosamente	_
governamental	governamentalmente	Abbr=Yes
governamentalmente	governamentalmente	_
graciosa	graciosamente	Abbr=Yes
graciosamente	graciosamente	_
gradativa	gradativamente	Abbr=Yes
gradativamente	gradativamente	_
gradual	gradualmente	Abbr=Yes
gradualmente	gradualmente	_
grafica	graficamente	Abbr=Yes
graficamente	graficamente	_
gramatica	gramaticamente	Abbr=Yes
gramatical	gramaticalmente	Abbr=Yes
gramaticalmente	gramaticalmente	_
gramaticamente	gramaticamente	_
grande	grandemente	Abbr=Yes
grandemente	grandemente	_
grandiosa	grandiosamente	Abbr=Yes
grandiosamente	grandiosamente	_
granitica	graniticamente	Abbr=Yes
graniticamente	graniticamente	_
grata	gratamente	Abbr=Yes
gratamente	gratamente	_
gratuita	gratuitamente	Abbr=Yes
gratuitamente	gratuitamente	_
grave	gravemente	Abbr=Yes
gravemente	gravemente	_
gritante	gritantemente	Abbr=Yes
gritantemente	gritantemente	_
grossa	grossamente	Abbr=Yes
grossamente	grossamente	_
grosseira	grosseiramente	Abbr=Yes
grosseiramente	grosseiramente	_
grosso	grosso	_
grotesca	grotescamente	Abbr=Yes
grotescamente	grotescamente	_
grupal	grupalmente	Abbr=Yes
grupalmente	grupalmente	_
gulosa	gulosamente	Abbr=Yes
gulosamente	gulosamente	_
habil	habilmente	Abbr=Yes
habilmente	habilmente	_
habitacional	habitacionalmente	Abbr=Yes
habitacionalmente	habitacionalmente	_
habitual	habitualmente	Abbr=Yes
habitualmente	habitualmente	_
harmonica	harmonicamente	Abbr=Yes
harmonicamente	harmonicamente	_
harmoniosa	harmoniosamente	Abbr=Yes
harmoniosamente	harmoniosamente	_
hedionda	hediondamente	Abbr=Yes
hediondamente	hediondamente	_
hegemonica	hegemonicamente	Abbr=Yes
hegemonicamente	hegemonicamente	_
helenista	helenistamente	Abbr=Yes
helenistamente	helenistamente	_
helenistica	helenisticamente	Abbr=Yes
helenisticamente	helenisticamente	_
hepatica	hepaticamente	Abbr=Yes
hepaticamente	hepaticamente	_
hereditaria	hereditariamente	Abbr=Yes
hereditariamente	hereditariamente	_
hermafrodita	hermafroditamente	Abbr=Yes
hermafroditamente	hermafroditamente	_
hermetica	hermeticamente	Abbr=Yes
hermeticamente	hermeticamente	_
heroica	heroicamente	Abbr=Yes
heroicamente	heroicamente	_
hesitante	hesitantemente	Abbr=Yes
hesitantemente	hesitantemente	_
heterogenea	heterogeneamente	Abbr=Yes
heterogeneamente	heterogeneamente	_
heteronimica	heteronimicamente	Abbr=Yes
heteronimicamente	heteronimicamente	_
heuristica	heuristicamente	Abbr=Yes
heuristicamente	heuristicamente	_
hidratada	hidratadamente	Abbr=Yes
hidratadamente	hidratadamente	_
hidraulica	hidraulicamente	Abbr=Yes
hidraulicamente	hidraulicamente	_
hidreletrica	hidreletricamente	Abbr=Yes
hidreletricamente	hidreletricamente	_
hidrica	hidricamente	Abbr=Yes
hidricamente	hidricamente	_
hidrostatica	hidrostaticamente	Abbr=Yes
hidrostaticamente	hidrostaticamente	_
hierarquica	hierarquicamente	Abbr=Yes
hierarquicamente	hierarquicamente	_
hilariante	hilariantemente	Abbr=Yes
hilariantemente	hilariantemente	_
hiper	hiper	_
hiperbolica	hiperbolicamente	Abbr=Yes
hiperbolicamente	hiperbolicamente	_
hipocrita	hipocritamente	Abbr=Yes
hipocritamente	hipocritamente	_
hipotetica	hipoteticamente	Abbr=Yes
hipoteticamente	hipoteticamente	_
histerica	histericamente	Abbr=Yes
histericamente	histericamente	_
historica	historicamente	Abbr=Yes
historicamente	historicamente	_
hodierna	hodiernamente	Abbr=Yes
hodiernamente	hodiernamente	_
hoje	hoje	_
holistica	holisticamente	Abbr=Yes
holisticamente	holisticamente	_
homogenea	homogeneamente	Abbr=Yes
homogeneamente	homogeneamente	_
homonimica	homonimicamente	Abbr=Yes
homonimicamente	homonimicamente	_
homossexual	homossexualmente	Abbr=Yes
homossexualmente	homossexualmente	_
honesta	honestamente	Abbr=Yes
honestamente	honestamente	_
honrada	honradamente	Abbr=Yes
honradamente	honradamente	_
honrosa	honrosamente	Abbr=Yes
honrosamente	honrosamente	_
horizontal	horizontalmente	Abbr=Yes
horizontalmente	horizontalmente	_
horrenda	horrendamente	Abbr=Yes
horrendamente	horrendamente	_
horripilante	horripilantemente	Abbr=Yes
horripilantemente	horripilantemente	_
horrivel	horrivelmente	Abbr=Yes
horrivelmente	horrivelmente	_
horrorosa	horrorosamente	Abbr=Yes
horrorosamente	horrorosamente	_
hospitaleira	hospitaleiramente	Abbr=Yes
hospitaleiramente	hospitaleiramente	_
hostil	hostilmente	Abbr=Yes
hostilmente	hostilmente	_
humana	humanamente	Abbr=Yes
humanamente	humanamente	_
humanista	humanistamente	Abbr=Yes
humanistamente	humanistamente	_
humanitaria	humanitariamente	Abbr=Yes
humanitariamente	humanitariamente	_
humilde	humildemente	Abbr=Yes
humildemente	humildemente	_
humilhante	humilhantemente	Abbr=Yes
humilhantemente	humilhantemente	_
iconografica	iconograficamente	Abbr=Yes
iconograficamente	iconograficamente	_
ideal	idealmente	Abbr=Yes
idealista	idealistamente	Abbr=Yes
idealistamente	idealistamente	_
idealmente	idealmente	_
identica	identicamente	Abbr=Yes
identicamente	identicamente	_
ideologica	ideologicamente	Abbr=Yes
ideologicamente	ideologicamente	_
idilica	idilicamente	Abbr=Yes
idilicamente	idilicamente	_
idiota	idiotamente	Abbr=Yes
idiotamente	idiotamente	_
ignorada	ignoradamente	Abbr=Yes
ignoradamente	ignoradamente	_
igual	igualmente	Abbr=Yes
igualitaria	igualitariamente	Abbr=Yes
igualitariamente	igualitariamente	_
igualmente	igualmente	_
ilegal	ilegalmente	Abbr=Yes
ilegalmente	ilegalmente	_
ilegitima	ilegitimamente	Abbr=Yes
ilegitimamente	ilegitimamente	_
ilicita	ilicitamente	Abbr=Yes
ilicitamente	ilicitamente	_
ilimitada	ilimitadamente	Abbr=Yes
ilimitadamente	ilimitadamente	_
ilusoria	ilusoriamente	Abbr=Yes
ilusoriamente	ilusoriamente	_
ilustradora	ilustradoramente	Abbr=Yes
ilustradoramente	ilustradoramente	_
ilustrativa	ilustrativamente	Abbr=Yes
ilustrativamente	ilustrativamente	_
imaculada	imaculadamente	Abbr=Yes
imaculadamente	imaculadamente	_
imagetica	imageticamente	Abbr=Yes
imageticamente	imageticamente	_
imaginaria	imaginariamente	Abbr=Yes
imaginariamente	imaginariamente	_
imbecil	imbecilmente	Abbr=Yes
imbecilmente	imbecilmente	_
imediata	imediatamente	Abbr=Yes
imediatamente	imediatamente	_
imemorial	imemorialmente	Abbr=Yes
imemorialmente	imemorialmente	_
imensa	imensamente	Abbr=Yes
imensamente	imensamente	_
imoderada	imoderadamente	Abbr=Yes
imoderadamente	imoderadamente	_
imortal	imortalmente	Abbr=Yes
imortalmente	imortalmente	_
imotivada	imotivadamente	Abbr=Yes
imotivadamente	imotivadamente	_
imovel	imovelmente	Abbr=Yes
imovelmente	imovelmente	_
impaciente	impacientemente	Abbr=Yes
impacientemente	impacientemente	_
imparcial	imparcialmente	Abbr=Yes
imparcialmente	imparcialmente	_
impassivel	impassivelmente	Abbr=Yes
impassivelmente	impassivelmente	_
impecavel	impecavelmente	Abbr=Yes
impecavelmente	impecavelmente	_
impensada	impensadamente	Abbr=Yes
impensadamente	impensadamente	_
imperativa	imperativamente	Abbr=Yes
imperativamente	imperativamente	_
imperceptivel	imperceptivelmente	Abbr=Yes
imperceptivelmente	imperceptivelmente	_
imperdoavel	imperdoavelmente	Abbr=Yes
imperdoavelmente	imperdoavelmente	_
imperfeita	imperfeitamente	Abbr=Yes
imperfeitamente	imperfeitamente	_
imperial	imperialmente	Abbr=Yes
imperialmente	imperialmente	_
imperiosa	imperiosamente	Abbr=Yes
imperiosamente	imperiosamente	_
impermeavel	impermeavelmente	Abbr=Yes
impermeavelmente	impermeavelmente	_
impessoal	impessoalmente	Abbr=Yes
impessoalmente	impessoalmente	_
impetravel	impetravelmente	Abbr=Yes
impetravelmente	impetravelmente	_
impiedosa	impiedosamente	Abbr=Yes
impiedosamente	impiedosamente	_
implacavel	implacavelmente	Abbr=Yes
implacavelmente	implacavelmente	_
implicita	implicitamente	Abbr=Yes
implicitamente	implicitamente	_
imponderavel	imponderavelmente	Abbr=Yes
imponderavelmente	imponderavelmente	_
imponente	imponentemente	Abbr=Yes
imponentemente	imponentemente	_
impopular	impopularmente	Abbr=Yes
impopularmente	impopularmente	_
importuna	importunamente	Abbr=Yes
importunamente	importunamente	_
impossivel	impossivelmente	Abbr=Yes
impossivelmente	impossivelmente	_
impostora	impostoramente	Abbr=Yes
impostoramente	impostoramente	_
impotente	impotentemente	Abbr=Yes
impotentemente	impotentemente	_
imprecisa	imprecisamente	Abbr=Yes
imprecisamente	imprecisamente	_
impressionante	impressionantemente	Abbr=Yes
impressionantemente	impressionantemente	_
imprestavel	imprestavelmente	Abbr=Yes
imprestavelmente	imprestavelmente	_
impreterivel	impreterivelmente	Abbr=Yes
impreterivelmente	impreterivelmente	_
imprevidente	imprevidentemente	Abbr=Yes
imprevidentemente	imprevidentemente	_
improdutiva	improdutivamente	Abbr=Yes
improdutivamente	improdutivamente	_
impropria	impropriamente	Abbr=Yes
impropriamente	impropriamente	_
improvisa	improvisamente	Abbr=Yes
improvisamente	improvisamente	_
imprudente	imprudentemente	Abbr=Yes
imprudentemente	imprudentemente	_
impudente	impudentemente	Abbr=Yes
impudentemente	impudentemente	_
impugnante	impugnantemente	Abbr=Yes
impugnantemente	impugnantemente	_
impulsiva	impulsivamente	Abbr=Yes
impulsivamente	impulsivamente	_
impune	impunemente	Abbr=Yes
impunemente	impunemente	_
imutavel	imutavelmente	Abbr=Yes
imutavelmente	imutavelmente	_
inaceitavel	inaceitavelmente	Abbr=Yes
inaceitavelmente	inaceitavelmente	_
inacreditavel	inacreditavelmente	Abbr=Yes
inacreditavelmente	inacreditavelmente	_
inadequada	inadequadamente	Abbr=Yes
inadequadamente	inadequadamente	_
inadvertida	inadvertidamente	Abbr=Yes
inadvertidamente	inadvertidamente	_
inalterada	inalteradamente	Abbr=Yes
inalteradamente	inalteradamente	_
inalteravel	inalteravelmente	Abbr=Yes
inalteravelmente	inalteravelmente	_
inamistosa	inamistosamente	Abbr=Yes
inamistosamente	inamistosamente	_
inapelavel	inapelavelmente	Abbr=Yes
inapelavelmente	inapelavelmente	_
inapropriada	inapropriadamente	Abbr=Yes
inapropriadamente	inapropriadamente	_
inarredavel	inarredavelmente	Abbr=Yes
inarredavelmente	inarredavelmente	_
inarticulada	inarticuladamente	Abbr=Yes
inarticuladamente	inarticuladamente	_
inata	inatamente	Abbr=Yes
inatamente	inatamente	_
inatingivel	inatingivelmente	Abbr=Yes
inatingivelmente	inatingivelmente	_
incalculavel	incalculavelmente	Abbr=Yes
incalculavelmente	incalculavelmente	_
incansavel	incansavelmente	Abbr=Yes
incansavelmente	incansavelmente	_
incerta	incertamente	Abbr=Yes
incertamente	incertamente	_
incessante	incessantemente	Abbr=Yes
incessantemente	incessantemente	_
incidental	incidentalmente	Abbr=Yes
incidentalmente	incidentalmente	_
incidente	incidentemente	Abbr=Yes
incidentemente	incidentemente	_
incisiva	incisivamente	Abbr=Yes
incisivamente	incisivamente	_
inclinada	inclinadamente	Abbr=Yes
inclinadamente	inclinadamente	_
inclusiva	inclusivamente	Abbr=Yes
inclusivamente	inclusivamente	_
inclusive	inclusive	_
incoerente	incoerentemente	Abbr=Yes
incoerentemente	incoerentemente	_
incomensuravel	incomensuravelmente	Abbr=Yes
incomensuravelmente	incomensuravelmente	_
incomoda	incomodamente	Abbr=Yes
incomodamente	incomodamente	_
incomparavel	incomparavelmente	Abbr=Yes
incomparavelmente	incomparavelmente	_
incompativel	incompativelmente	Abbr=Yes
incompativelmente	incompativelmente	_
incompleta	incompletamente	Abbr=Yes
incompletamente	incompletamente	_
incompreensivel	incompreensivelmente	Abbr=Yes
incompreensivelmente	incompreensivelmente	_
incondicional	incondicionalmente	Abbr=Yes
incondicionalmente	incondicionalmente	_
inconfessada	inconfessadamente	Abbr=Yes
inconfessadamente	inconfessadamente	_
inconfundivel	inconfundivelmente	Abbr=Yes
inconfundivelmente	inconfundivelmente	_
inconsciente	inconscientemente	Abbr=Yes
inconscientemente	inconscientemente	_
inconsequente	inconsequentemente	Abbr=Yes
inconsequentemente	inconsequentemente	_
inconsiderada	inconsideradamente	Abbr=Yes
inconsideradamente	inconsideradamente	_
inconsolada	inconsoladamente	Abbr=Yes
inconsoladamente	inconsoladamente	_
inconstante	inconstantemente	Abbr=Yes
inconstantemente	inconstantemente	_
inconstitucional	inconstitucionalmente	Abbr=Yes
inconstitucionalmente	inconstitucionalmente	_
incontestavel	incontestavelmente	Abbr=Yes
incontestavelmente	incontestavelmente	_
incontrolavel	incontrolavelmente	Abbr=Yes
incontrolavelmente	incontrolavelmente	_
inconveniente	inconvenientemente	Abbr=Yes
inconvenientemente	inconvenientemente	_
incorporea	incorporeamente	Abbr=Yes
incorporeamente	incorporeamente	_
incorreta	incorretamente	Abbr=Yes
incorretamente	incorretamente	_
incorrigivel	incorrigivelmente	Abbr=Yes
incorrigivelmente	incorrigivelmente	_
incorruptivel	incorruptivelmente	Abbr=Yes
incorruptivelmente	incorruptivelmente	_
incredula	incredulamente	Abbr=Yes
incredulamente	incredulamente	_
incrivel	incrivelmente	Abbr=Yes
incrivelmente	incrivelmente	_
indebita	indebitamente	Abbr=Yes
indebitamente	indebitamente	_
indecente	indecentemente	Abbr=Yes
indecentemente	indecentemente	_
indefinida	indefinidamente	Abbr=Yes
indefinidamente	indefinidamente	_
indelevel	indelevelmente	Abbr=Yes
indelevelmente	indelevelmente	_
indelicada	indelicadamente	Abbr=Yes
indelicadamente	indelicadamente	_
independente	independente	_
independente	independentemente	Abbr=Yes
independentemente	independentemente	_
indescritivel	indescritivelmente	Abbr=Yes
indescritivelmente	indescritivelmente	_
indesculpavel	indesculpavelmente	Abbr=Yes
indesculpavelmente	indesculpavelmente	_
indesejavel	indesejavelmente	Abbr=Yes
indesejavelmente	indesejavelmente	_
indeterminada	indeterminadamente	Abbr=Yes
indeterminadamente	indeterminadamente	_
indevida	indevidamente	Abbr=Yes
indevidamente	indevidamente	_
indiana	indianamente	Abbr=Yes
indianamente	indianamente	_
indianista	indianistamente	Abbr=Yes
indianistamente	indianistamente	_
indicativa	indicativamente	Abbr=Yes
indicativamente	indicativamente	_
indiferente	indiferentemente	Abbr=Yes
indiferentemente	indiferentemente	_
indigena	indigenamente	Abbr=Yes
indigenamente	indigenamente	_
indigente	indigentemente	Abbr=Yes
indigentemente	indigentemente	_
indigna	indignamente	Abbr=Yes
indignamente	indignamente	_
indireta	indiretamente	Abbr=Yes
indiretamente	indiretamente	_
indiscreta	indiscretamente	Abbr=Yes
indiscretamente	indiscretamente	_
indiscriminada	indiscriminadamente	Abbr=Yes
indiscriminadamente	indiscriminadamente	_
indiscutivel	indiscutivelmente	Abbr=Yes
indiscutivelmente	indiscutivelmente	_
indispensavel	indispensavelmente	Abbr=Yes
indispensavelmente	indispensavelmente	_
indissociavel	indissociavelmente	Abbr=Yes
indissociavelmente	indissociavelmente	_
indissoluvel	indissoluvelmente	Abbr=Yes
indissoluvelmente	indissoluvelmente	_
indistinta	indistintamente	Abbr=Yes
indistintamente	indistintamente	_
individual	individualmente	Abbr=Yes
individualista	individualistamente	Abbr=Yes
individualistamente	individualistamente	_
individualmente	individualmente	_
indivisivel	indivisivelmente	Abbr=Yes
indivisivelmente	indivisivelmente	_
indizivel	indizivelmente	Abbr=Yes
indizivelmente	indizivelmente	_
indolente	indolentemente	Abbr=Yes
indolentemente	indolentemente	_
indubitavel	indubitavelmente	Abbr=Yes
indubitavelmente	indubitavelmente	_
industrial	industrialmente	Abbr=Yes
industrialmente	industrialmente	_
indutiva	indutivamente	Abbr=Yes
indutivamente	indutivamente	_
induvidosa	induvidosamente	Abbr=Yes
induvidosamente	induvidosamente	_
inedita	ineditamente	Abbr=Yes
ineditamente	ineditamente	_
inegavel	inegavelmente	Abbr=Yes
inegavelmente	inegavelmente	_
inelutavel	inelutavelmente	Abbr=Yes
inelutavelmente	inelutavelmente	_
inequivoca	inequivocamente	Abbr=Yes
inequivocamente	inequivocamente	_
inercial	inercialmente	Abbr=Yes
inercialmente	inercialmente	_
inerente	inerentemente	Abbr=Yes
inerentemente	inerentemente	_
inescapavel	inescapavelmente	Abbr=Yes
inescapavelmente	inescapavelmente	_
inescrupulosa	inescrupulosamente	Abbr=Yes
inescrupulosamente	inescrupulosamente	_
inesperada	inesperadamente	Abbr=Yes
inesperadamente	inesperadamente	_
inevitavel	inevitavelmente	Abbr=Yes
inevitavelmente	inevitavelmente	_
inexoravel	inexoravelmente	Abbr=Yes
inexoravelmente	inexoravelmente	_
inexperiente	inexperientemente	Abbr=Yes
inexperientemente	inexperientemente	_
inexplicavel	inexplicavelmente	Abbr=Yes
inexplicavelmente	inexplicavelmente	_
inexprimivel	inexprimivelmente	Abbr=Yes
inexprimivelmente	inexprimivelmente	_
inextricavel	inextricavelmente	Abbr=Yes
inextricavelmente	inextricavelmente	_
infalivel	infalivelmente	Abbr=Yes
infalivelmente	infalivelmente	_
infantil	infantilmente	Abbr=Yes
infantilmente	infantilmente	_
infatigavel	infatigavelmente	Abbr=Yes
infatigavelmente	infatigavelmente	_
infeliz	infelizmente	Abbr=Yes
infelizmente	infelizmente	_
inferior	inferiormente	Abbr=Yes
inferiormente	inferiormente	_
infiel	infielmente	Abbr=Yes
infielmente	infielmente	_
infima	infimamente	Abbr=Yes
infimamente	infimamente	_
infinita	infinitamente	Abbr=Yes
infinitamente	infinitamente	_
infinitesimal	infinitesimalmente	Abbr=Yes
infinitesimalmente	infinitesimalmente	_
inflacionaria	inflacionariamente	Abbr=Yes
inflacionariamente	inflacionariamente	_
inflamavel	inflamavelmente	Abbr=Yes
inflamavelmente	inflamavelmente	_
inflexivel	inflexivelmente	Abbr=Yes
inflexivelmente	inflexivelmente	_
informal	informalmente	Abbr=Yes
informalmente	informalmente	_
ingenua	ingenuamente	Abbr=Yes
ingenuamente	ingenuamente	_
ingloria	ingloriamente	Abbr=Yes
ingloriamente	ingloriamente	_
inibitoria	inibitoriamente	Abbr=Yes
inibitoriamente	inibitoriamente	_
inicial	inicialmente	Abbr=Yes
inicialmente	inicialmente	_
inimaginavel	inimaginavelmente	Abbr=Yes
inimaginavelmente	inimaginavelmente	_
ininterrupta	ininterruptamente	Abbr=Yes
ininterruptamente	ininterruptamente	_
injusta	injustamente	Abbr=Yes
injustamente	injustamente	_
inocente	inocentemente	Abbr=Yes
inocentemente	inocentemente	_
inovadora	inovadoramente	Abbr=Yes
inovadoramente	inovadoramente	_
inquestionavel	inquestionavelmente	Abbr=Yes
inquestionavelmente	inquestionavelmente	_
inquietante	inquietantemente	Abbr=Yes
inquietantemente	inquietantemente	_
inquisitorial	inquisitorialmente	Abbr=Yes
inquisitorialmente	inquisitorialmente	_
insaciavel	insaciavelmente	Abbr=Yes
insaciavelmente	insaciavelmente	_
insana	insanamente	Abbr=Yes
insanamente	insanamente	_
insatisfatoria	insatisfatoriamente	Abbr=Yes
insatisfatoriamente	insatisfatoriamente	_
insensata	insensatamente	Abbr=Yes
insensatamente	insensatamente	_
insensivel	insensivelmente	Abbr=Yes
insensivelmente	insensivelmente	_
inseparavel	inseparavelmente	Abbr=Yes
inseparavelmente	inseparavelmente	_
insidiosa	insidiosamente	Abbr=Yes
insidiosamente	insidiosamente	_
insignificante	insignificantemente	Abbr=Yes
insignificantemente	insignificantemente	_
insistente	insistentemente	Abbr=Yes
insistentemente	insistentemente	_
insofismavel	insofismavelmente	Abbr=Yes
insofismavelmente	insofismavelmente	_
insolente	insolentemente	Abbr=Yes
insolentemente	insolentemente	_
insolita	insolitamente	Abbr=Yes
insolitamente	insolitamente	_
insossa	insossamente	Abbr=Yes
insossamente	insossamente	_
instantanea	instantaneamente	Abbr=Yes
instantaneamente	instantaneamente	_
instintiva	instintivamente	Abbr=Yes
instintivamente	instintivamente	_
institucional	institucionalmente	Abbr=Yes
institucionalmente	institucionalmente	_
instrumental	instrumentalmente	Abbr=Yes
instrumentalmente	instrumentalmente	_
insubjugavel	insubjugavelmente	Abbr=Yes
insubjugavelmente	insubjugavelmente	_
insubordinada	insubordinadamente	Abbr=Yes
insubordinadamente	insubordinadamente	_
insuficiente	insuficientemente	Abbr=Yes
insuficientemente	insuficientemente	_
insuportavel	insuportavelmente	Abbr=Yes
insuportavelmente	insuportavelmente	_
insurgente	insurgentemente	Abbr=Yes
insurgentemente	insurgentemente	_
insustentavel	insustentavelmente	Abbr=Yes
insustentavelmente	insustentavelmente	_
integra	integramente	Abbr=Yes
integral	integralmente	Abbr=Yes
integralmente	integralmente	_
integramente	integramente	_
inteira	inteiramente	Abbr=Yes
inteiramente	inteiramente	_
inteiriça	inteiriçamente	Abbr=Yes
inteiriçamente	inteiriçamente	_
intelectual	intelectualmente	Abbr=Yes
intelectualmente	intelectualmente	_
inteligente	inteligentemente	Abbr=Yes
inteligentemente	inteligentemente	_
intempestiva	intempestivamente	Abbr=Yes
intempestivamente	intempestivamente	_
intencional	intencionalmente	Abbr=Yes
intencionalmente	intencionalmente	_
intensa	intensamente	Abbr=Yes
intensamente	intensamente	_
intensiva	intensivamente	Abbr=Yes
intensivamente	intensivamente	_
interativa	interativamente	Abbr=Yes
interativamente	interativamente	_
interessante	interessantemente	Abbr=Yes
interessantemente	interessantemente	_
interesseira	interesseiramente	Abbr=Yes
interesseiramente	interesseiramente	_
interina	interinamente	Abbr=Yes
interinamente	interinamente	_
interior	interiormente	Abbr=Yes
interiormente	interiormente	_
interminavel	interminavelmente	Abbr=Yes
interminavelmente	interminavelmente	_
intermitente	intermitentemente	Abbr=Yes
intermitentemente	intermitentemente	_
interna	internamente	Abbr=Yes
internacional	internacionalmente	Abbr=Yes
internacionalista	internacionalistamente	Abbr=Yes
internacionalistamente	internacionalistamente	_
internacionalmente	internacionalmente	_
internamente	internamente	_
interpessoal	interpessoalmente	Abbr=Yes
interpessoalmente	interpessoalmente	_
interplanetaria	interplanetariamente	Abbr=Yes
interplanetariamente	interplanetariamente	_
interpretante	interpretantemente	Abbr=Yes
interpretantemente	interpretantemente	_
interpretativa	interpretativamente	Abbr=Yes
interpretativamente	interpretativamente	_
interrogativa	interrogativamente	Abbr=Yes
interrogativamente	interrogativamente	_
intersubjetiva	intersubjetivamente	Abbr=Yes
intersubjetivamente	intersubjetivamente	_
intima	intimamente	Abbr=Yes
intimamente	intimamente	_
intocavel	intocavelmente	Abbr=Yes
intocavelmente	intocavelmente	_
intolerante	intolerantemente	Abbr=Yes
intolerantemente	intolerantemente	_
intoleravel	intoleravelmente	Abbr=Yes
intoleravelmente	intoleravelmente	_
intracelular	intracelularmente	Abbr=Yes
intracelularmente	intracelularmente	_
intransigente	intransigentemente	Abbr=Yes
intransigentemente	intransigentemente	_
intrepida	intrepidamente	Abbr=Yes
intrepidamente	intrepidamente	_
intrigante	intrigantemente	Abbr=Yes
intrigantemente	intrigantemente	_
intrinseca	intrinsecamente	Abbr=Yes
intrinsecamente	intrinsecamente	_
intuitiva	intuitivamente	Abbr=Yes
intuitivamente	intuitivamente	_
inusitada	inusitadamente	Abbr=Yes
inusitadamente	inusitadamente	_
inutil	inutilmente	Abbr=Yes
inutilmente	inutilmente	_
invariavel	invariavelmente	Abbr=Yes
invariavelmente	invariavelmente	_
invectiva	invectivamente	Abbr=Yes
invectivamente	invectivamente	_
invejavel	invejavelmente	Abbr=Yes
invejavelmente	invejavelmente	_
invejosa	invejosamente	Abbr=Yes
invejosamente	invejosamente	_
inveridica	inveridicamente	Abbr=Yes
inveridicamente	inveridicamente	_
inverossimil	inverossimilmente	Abbr=Yes
inverossimilmente	inverossimilmente	_
inversa	inversamente	Abbr=Yes
inversamente	inversamente	_
inviavel	inviavelmente	Abbr=Yes
inviavelmente	inviavelmente	_
inviolavel	inviolavelmente	Abbr=Yes
inviolavelmente	inviolavelmente	_
invisivel	invisivelmente	Abbr=Yes
invisivelmente	invisivelmente	_
invocatoria	invocatoriamente	Abbr=Yes
invocatoriamente	invocatoriamente	_
involuntaria	involuntariamente	Abbr=Yes
involuntariamente	involuntariamente	_
ironica	ironicamente	Abbr=Yes
ironicamente	ironicamente	_
irracional	irracionalmente	Abbr=Yes
irracionalmente	irracionalmente	_
irrecorrivel	irrecorrivelmente	Abbr=Yes
irrecorrivelmente	irrecorrivelmente	_
irrecuperavel	irrecuperavelmente	Abbr=Yes
irrecuperavelmente	irrecuperavelmente	_
irredutivel	irredutivelmente	Abbr=Yes
irredutivelmente	irredutivelmente	_
irrefletida	irrefletidamente	Abbr=Yes
irrefletidamente	irrefletidamente	_
irrefreavel	irrefreavelmente	Abbr=Yes
irrefreavelmente	irrefreavelmente	_
irrefutavel	irrefutavelmente	Abbr=Yes
irrefutavelmente	irrefutavelmente	_
irregular	irregularmente	Abbr=Yes
irregularmente	irregularmente	_
irremediavel	irremediavelmente	Abbr=Yes
irremediavelmente	irremediavelmente	_
irreparavel	irreparavelmente	Abbr=Yes
irreparavelmente	irreparavelmente	_
irrepreensivel	irrepreensivelmente	Abbr=Yes
irrepreensivelmente	irrepreensivelmente	_
irresistivel	irresistivelmente	Abbr=Yes
irresistivelmente	irresistivelmente	_
irresponsavel	irresponsavelmente	Abbr=Yes
irresponsavelmente	irresponsavelmente	_
irrestrita	irrestritamente	Abbr=Yes
irrestritamente	irrestritamente	_
irretocavel	irretocavelmente	Abbr=Yes
irretocavelmente	irretocavelmente	_
irreverenciosamente	irreverenciosamente	_
irreverente	irreverentemente	Abbr=Yes
irreverentemente	irreverentemente	_
irreversivel	irreversivelmente	Abbr=Yes
irreversivelmente	irreversivelmente	_
irrevogavel	irrevogavelmente	Abbr=Yes
irrevogavelmente	irrevogavelmente	_
irritante	irritantemente	Abbr=Yes
irritantemente	irritantemente	_
isoclinal	isoclinalmente	Abbr=Yes
isoclinalmente	isoclinalmente	_
isolada	isoladamente	Abbr=Yes
isoladamente	isoladamente	_
isotermica	isotermicamente	Abbr=Yes
isotermicamente	isotermicamente	_
isotopica	isotopicamente	Abbr=Yes
isotopicamente	isotopicamente	_
iterativa	iterativamente	Abbr=Yes
iterativamente	iterativamente	_
jamais	jamais	_
jeca	jecamente	Abbr=Yes
jecamente	jecamente	_
jocosa	jocosamente	Abbr=Yes
jocosamente	jocosamente	_
jornalistica	jornalisticamente	Abbr=Yes
jornalisticamente	jornalisticamente	_
jovial	jovialmente	Abbr=Yes
jovialmente	jovialmente	_
judicial	judicialmente	Abbr=Yes
judicialmente	judicialmente	_
judiciosa	judiciosamente	Abbr=Yes
judiciosamente	judiciosamente	_
junta	juntamente	Abbr=Yes
juntamente	juntamente	_
junto	junto	_
juridica	juridicamente	Abbr=Yes
juridicamente	juridicamente	_
justa	justamente	Abbr=Yes
justamente	justamente	_
justificada	justificadamente	Abbr=Yes
justificadamente	justificadamente	_
justo	justo	_
juvenil	juvenilmente	Abbr=Yes
juvenilmente	juvenilmente	_
já	já	_
labial	labialmente	Abbr=Yes
labialmente	labialmente	_
labiodental	labiodentalmente	Abbr=Yes
labiodentalmente	labiodentalmente	_
laboratorial	laboratorialmente	Abbr=Yes
laboratorialmente	laboratorialmente	_
laboriosa	laboriosamente	Abbr=Yes
laboriosamente	laboriosamente	_
laconica	laconicamente	Abbr=Yes
laconicamente	laconicamente	_
lactante	lactantemente	Abbr=Yes
lactantemente	lactantemente	_
lamentavel	lamentavelmente	Abbr=Yes
lamentavelmente	lamentavelmente	_
lamentosa	lamentosamente	Abbr=Yes
lamentosamente	lamentosamente	_
languida	languidamente	Abbr=Yes
languidamente	languidamente	_
larga	largamente	Abbr=Yes
largamente	largamente	_
lastimadora	lastimadoramente	Abbr=Yes
lastimadoramente	lastimadoramente	_
lastimavel	lastimavelmente	Abbr=Yes
lastimavelmente	lastimavelmente	_
lateral	lateralmente	Abbr=Yes
lateralmente	lateralmente	_
lauta	lautamente	Abbr=Yes
lautamente	lautamente	_
leal	lealmente	Abbr=Yes
lealmente	lealmente	_
legal	legalmente	Abbr=Yes
legalista	legalistamente	Abbr=Yes
legalistamente	legalistamente	_
legalmente	legalmente	_
legitima	legitimamente	Abbr=Yes
legitimamente	legitimamente	_
legivel	legivelmente	Abbr=Yes
legivelmente	legivelmente	_
lendaria	lendariamente	Abbr=Yes
lendariamente	lendariamente	_
lenta	lentamente	Abbr=Yes
lentamente	lentamente	_
lento	lento	_
leve	leve	_
leve	levemente	Abbr=Yes
levemente	levemente	_
leviana	levianamente	Abbr=Yes
levianamente	levianamente	_
lexica	lexicamente	Abbr=Yes
lexical	lexicalmente	Abbr=Yes
lexicalmente	lexicalmente	_
lexicamente	lexicamente	_
lexicografica	lexicograficamente	Abbr=Yes
lexicograficamente	lexicograficamente	_
liberal	liberalmente	Abbr=Yes
liberalmente	liberalmente	_
licenciosa	licenciosamente	Abbr=Yes
licenciosamente	licenciosamente	_
licita	licitamente	Abbr=Yes
licitamente	licitamente	_
ligeira	ligeiramente	Abbr=Yes
ligeiramente	ligeiramente	_
ligeiro	ligeiro	_
liminar	liminarmente	Abbr=Yes
liminarmente	liminarmente	_
limitada	limitadamente	Abbr=Yes
limitadamente	limitadamente	_
limitante	limitantemente	Abbr=Yes
limitantemente	limitantemente	_
limpida	limpidamente	Abbr=Yes
limpidamente	limpidamente	_
limpo	limpo	_
linda	lindamente	Abbr=Yes
lindamente	lindamente	_
linear	linearmente	Abbr=Yes
linearmente	linearmente	_
linguistica	linguisticamente	Abbr=Yes
linguisticamente	linguisticamente	_
linguodental	linguodentalmente	Abbr=Yes
linguodentalmente	linguodentalmente	_
liquida	liquidamente	Abbr=Yes
liquidamente	liquidamente	_
lirica	liricamente	Abbr=Yes
liricamente	liricamente	_
literal	literalmente	Abbr=Yes
literalmente	literalmente	_
literaria	literariamente	Abbr=Yes
literariamente	literariamente	_
litoral	litoralmente	Abbr=Yes
litoralmente	litoralmente	_
livre	livremente	Abbr=Yes
livremente	livremente	_
local	localmente	Abbr=Yes
localmente	localmente	_
logica	logicamente	Abbr=Yes
logicamente	logicamente	_
logistica	logisticamente	Abbr=Yes
logisticamente	logisticamente	_
logo	logo	_
longa	longamente	Abbr=Yes
longamente	longamente	_
longe	longe	_
longinho	longinho	_
longinqua	longinquamente	Abbr=Yes
longinquamente	longinquamente	_
longitudinal	longitudinalmente	Abbr=Yes
longitudinalmente	longitudinalmente	_
louca	loucamente	Abbr=Yes
loucamente	loucamente	_
lucida	lucidamente	Abbr=Yes
lucidamente	lucidamente	_
lucrativa	lucrativamente	Abbr=Yes
lucrativamente	lucrativamente	_
ludica	ludicamente	Abbr=Yes
ludicamente	ludicamente	_
luminosa	luminosamente	Abbr=Yes
luminosamente	luminosamente	_
luterana	luteranamente	Abbr=Yes
luteranamente	luteranamente	_
luxuosa	luxuosamente	Abbr=Yes
luxuosamente	luxuosamente	_
luxuriante	luxuriantemente	Abbr=Yes
luxuriantemente	luxuriantemente	_
lá	lá	_
macabra	macabramente	Abbr=Yes
macabramente	macabramente	_
machista	machistamente	Abbr=Yes
machistamente	machistamente	_
maciça	maciçamente	Abbr=Yes
maciçamente	maciçamente	_
macrobiotica	macrobioticamente	Abbr=Yes
macrobioticamente	macrobioticamente	_
macroeconomica	macroeconomicamente	Abbr=Yes
macroeconomicamente	macroeconomicamente	_
macroscopica	macroscopicamente	Abbr=Yes
macroscopicamente	macroscopicamente	_
magica	magicamente	Abbr=Yes
magicamente	magicamente	_
magistral	magistralmente	Abbr=Yes
magistralmente	magistralmente	_
magnetica	magneticamente	Abbr=Yes
magneticamente	magneticamente	_
magnifica	magnificamente	Abbr=Yes
magnificamente	magnificamente	_
magra	magramente	Abbr=Yes
magramente	magramente	_
maior	maiormente	Abbr=Yes
maiormente	maiormente	_
mais	mais	_
majestosa	majestosamente	Abbr=Yes
majestosamente	majestosamente	_
majoritaria	majoritariamente	Abbr=Yes
majoritariamente	majoritariamente	_
mal	mal	_
malandra	malandramente	Abbr=Yes
malandramente	malandramente	_
malcriada	malcriadamente	Abbr=Yes
malcriadamente	malcriadamente	_
maldosa	maldosamente	Abbr=Yes
maldosamente	maldosamente	_
maliciosa	maliciosamente	Abbr=Yes
maliciosamente	maliciosamente	_
maligna	malignamente	Abbr=Yes
malignamente	malignamente	_
malmente	malmente	_
malvada	malvadamente	Abbr=Yes
malvadamente	malvadamente	_
mandona	mandonamente	Abbr=Yes
mandonamente	mandonamente	_
manhosa	manhosamente	Abbr=Yes
manhosamente	manhosamente	_
manifesta	manifestamente	Abbr=Yes
manifestada	manifestadamente	Abbr=Yes
manifestadamente	manifestadamente	_
manifestamente	manifestamente	_
mansa	mansamente	Abbr=Yes
mansamente	mansamente	_
manso	manso	_
manual	manualmente	Abbr=Yes
manualmente	manualmente	_
maquiavelica	maquiavelicamente	Abbr=Yes
maquiavelicamente	maquiavelicamente	_
maravilhosa	maravilhosamente	Abbr=Yes
maravilhosamente	maravilhosamente	_
marcada	marcadamente	Abbr=Yes
marcadamente	marcadamente	_
marcante	marcantemente	Abbr=Yes
marcantemente	marcantemente	_
marcial	marcialmente	Abbr=Yes
marcialmente	marcialmente	_
marginal	marginalmente	Abbr=Yes
marginalmente	marginalmente	_
marital	maritalmente	Abbr=Yes
maritalmente	maritalmente	_
marota	marotamente	Abbr=Yes
marotamente	marotamente	_
marxista	marxistamente	Abbr=Yes
marxistamente	marxistamente	_
masoquista	masoquistamente	Abbr=Yes
masoquistamente	masoquistamente	_
matematica	matematicamente	Abbr=Yes
matematicamente	matematicamente	_
material	materialmente	Abbr=Yes
materialista	materialistamente	Abbr=Yes
materialistamente	materialistamente	_
materialmente	materialmente	_
materna	maternamente	Abbr=Yes
maternal	maternalmente	Abbr=Yes
maternalmente	maternalmente	_
maternamente	maternamente	_
matinal	matinalmente	Abbr=Yes
matinalmente	matinalmente	_
matrimonial	matrimonialmente	Abbr=Yes
matrimonialmente	matrimonialmente	_
matutina	matutinamente	Abbr=Yes
matutinamente	matutinamente	_
maxima	maximamente	Abbr=Yes
maximamente	maximamente	_
mecanica	mecanicamente	Abbr=Yes
mecanicamente	mecanicamente	_
media	mediamente	Abbr=Yes
medial	medialmente	Abbr=Yes
medialmente	medialmente	_
mediamente	mediamente	_
mediana	medianamente	Abbr=Yes
medianamente	medianamente	_
medicinal	medicinalmente	Abbr=Yes
medicinalmente	medicinalmente	_
medieval	medievalmente	Abbr=Yes
medievalista	medievalistamente	Abbr=Yes
medievalistamente	medievalistamente	_
medievalisticamente	medievalisticamente	_
medievalmente	medievalmente	_
mediocre	mediocremente	Abbr=Yes
mediocremente	mediocremente	_
mega	mega	_
meiga	meigamente	Abbr=Yes
meigamente	meigamente	_
meio	meio	_
melancolica	melancolicamente	Abbr=Yes
melancolicamente	melancolicamente	_
melhor	melhor	_
melindrosa	melindrosamente	Abbr=Yes
melindrosamente	melindrosamente	_
melodica	melodicamente	Abbr=Yes
melodicamente	melodicamente	_
melodiosa	melodiosamente	Abbr=Yes
melodiosamente	melodiosamente	_
melodramatica	melodramaticamente	Abbr=Yes
melodramaticamente	melodramaticamente	_
melosa	melosamente	Abbr=Yes
melosamente	melosamente	_
memoravel	memoravelmente	Abbr=Yes
memoravelmente	memoravelmente	_
menos	menos	_
menosprezada	menosprezadamente	Abbr=Yes
menosprezadamente	menosprezadamente	_
mensal	mensalmente	Abbr=Yes
mensalmente	mensalmente	_
mental	mentalmente	Abbr=Yes
mentalmente	mentalmente	_
mera	meramente	Abbr=Yes
meramente	meramente	_
mercadologica	mercadologicamente	Abbr=Yes
mercadologicamente	mercadologicamente	_
meridiana	meridianamente	Abbr=Yes
meridianamente	meridianamente	_
meridional	meridionalmente	Abbr=Yes
meridionalmente	meridionalmente	_
mesmo	mesmo	_
mesquinha	mesquinhamente	Abbr=Yes
mesquinhamente	mesquinhamente	_
metabolica	metabolicamente	Abbr=Yes
metabolicamente	metabolicamente	_
metafisica	metafisicamente	Abbr=Yes
metafisicamente	metafisicamente	_
metaforica	metaforicamente	Abbr=Yes
metaforicamente	metaforicamente	_
metalurgica	metalurgicamente	Abbr=Yes
metalurgicamente	metalurgicamente	_
meticulosa	meticulosamente	Abbr=Yes
meticulosamente	meticulosamente	_
metodica	metodicamente	Abbr=Yes
metodicamente	metodicamente	_
metodista	metodistamente	Abbr=Yes
metodistamente	metodistamente	_
metodisticamente	metodisticamente	_
metodologica	metodologicamente	Abbr=Yes
metodologicamente	metodologicamente	_
metonimica	metonimicamente	Abbr=Yes
metonimicamente	metonimicamente	_
metrica	metricamente	Abbr=Yes
metricamente	metricamente	_
mexicana	mexicanamente	Abbr=Yes
mexicanamente	mexicanamente	_
microbial	microbialmente	Abbr=Yes
microbialmente	microbialmente	_
microscopica	microscopicamente	Abbr=Yes
microscopicamente	microscopicamente	_
milagrosa	milagrosamente	Abbr=Yes
milagrosamente	milagrosamente	_
milenar	milenarmente	Abbr=Yes
milenarmente	milenarmente	_
militante	militantemente	Abbr=Yes
militantemente	militantemente	_
militar	militarmente	Abbr=Yes
militarmente	militarmente	_
mimetica	mimeticamente	Abbr=Yes
mimeticamente	mimeticamente	_
mimica	mimicamente	Abbr=Yes
mimicamente	mimicamente	_
mimosa	mimosamente	Abbr=Yes
mimosamente	mimosamente	_
mineira	mineiramente	Abbr=Yes
mineiramente	mineiramente	_
mineral	mineralmente	Abbr=Yes
mineralmente	mineralmente	_
minima	minimamente	Abbr=Yes
minimamente	minimamente	_
ministerial	ministerialmente	Abbr=Yes
ministerialmente	ministerialmente	_
minoritaria	minoritariamente	Abbr=Yes
minoritariamente	minoritariamente	_
minuciosa	minuciosamente	Abbr=Yes
minuciosamente	minuciosamente	_
minuscula	minusculamente	Abbr=Yes
minusculamente	minusculamente	_
miope	miopemente	Abbr=Yes
miopemente	miopemente	_
miraculosa	miraculosamente	Abbr=Yes
miraculosamente	miraculosamente	_
miseravel	miseravelmente	Abbr=Yes
miseravelmente	miseravelmente	_
misericordiosa	misericordiosamente	Abbr=Yes
misericordiosamente	misericordiosamente	_
misericordiosissimamente	misericordiosissimamente	_
misteriosa	misteriosamente	Abbr=Yes
misteriosamente	misteriosamente	_
mistica	misticamente	Abbr=Yes
misticamente	misticamente	_
misturada	misturadamente	Abbr=Yes
misturadamente	misturadamente	_
mitica	miticamente	Abbr=Yes
miticamente	miticamente	_
miuda	miudamente	Abbr=Yes
miudamente	miudamente	_
mnemonica	mnemonicamente	Abbr=Yes
mnemonicamente	mnemonicamente	_
modal	modalmente	Abbr=Yes
modalmente	modalmente	_
moderada	moderadamente	Abbr=Yes
moderadamente	moderadamente	_
moderna	modernamente	Abbr=Yes
modernamente	modernamente	_
modesta	modestamente	Abbr=Yes
modestamente	modestamente	_
mole	mole	_
mole	molemente	Abbr=Yes
molemente	molemente	_
momentanea	momentaneamente	Abbr=Yes
momentaneamente	momentaneamente	_
monarquica	monarquicamente	Abbr=Yes
monarquicamente	monarquicamente	_
monetaria	monetariamente	Abbr=Yes
monetariamente	monetariamente	_
monolitica	monoliticamente	Abbr=Yes
monoliticamente	monoliticamente	_
monotona	monotonamente	Abbr=Yes
monotonamente	monotonamente	_
monstruosa	monstruosamente	Abbr=Yes
monstruosamente	monstruosamente	_
mor	mormente	Abbr=Yes
moral	moralmente	Abbr=Yes
moralmente	moralmente	_
morbida	morbidamente	Abbr=Yes
morbidamente	morbidamente	_
morfologica	morfologicamente	Abbr=Yes
morfologicamente	morfologicamente	_
mormente	mormente	_
morosa	morosamente	Abbr=Yes
morosamente	morosamente	_
mortal	mortalmente	Abbr=Yes
mortalmente	mortalmente	_
mortiça	mortiçamente	Abbr=Yes
mortiçamente	mortiçamente	_
motivada	motivadamente	Abbr=Yes
motivadamente	motivadamente	_
motora	motoramente	Abbr=Yes
motoramente	motoramente	_
muito	muito	_
muitíssimo	muitíssimo	_
multilateral	multilateralmente	Abbr=Yes
multilateralmente	multilateralmente	_
multinacional	multinacionalmente	Abbr=Yes
multinacionalmente	multinacionalmente	_
multipla	multiplamente	Abbr=Yes
multiplamente	multiplamente	_
multiplicada	multiplicadamente	Abbr=Yes
multiplicadamente	multiplicadamente	_
multiplicativa	multiplicativamente	Abbr=Yes
multiplicativamente	multiplicativamente	_
multissecular	multissecularmente	Abbr=Yes
multissecularmente	multissecularmente	_
mundial	mundialmente	Abbr=Yes
mundialmente	mundialmente	_
municipal	municipalmente	Abbr=Yes
municipalmente	municipalmente	_
musical	musicalmente	Abbr=Yes
musicalmente	musicalmente	_
mutua	mutuamente	Abbr=Yes
mutuamente	mutuamente	_
nababesca	nababescamente	Abbr=Yes
nababescamente	nababescamente	_
nacional	nacionalmente	Abbr=Yes
nacionalista	nacionalistamente	Abbr=Yes
nacionalistamente	nacionalistamente	_
nacionalmente	nacionalmente	_
nada	nada	_
narrativa	narrativamente	Abbr=Yes
narrativamente	narrativamente	_
nasal	nasalmente	Abbr=Yes
nasalmente	nasalmente	_
nativisticamente	nativisticamente	_
natural	naturalmente	Abbr=Yes
naturalmente	naturalmente	_
nauseante	nauseantemente	Abbr=Yes
nauseantemente	nauseantemente	_
nazista	nazistamente	Abbr=Yes
nazistamente	nazistamente	_
nebulosa	nebulosamente	Abbr=Yes
nebulosamente	nebulosamente	_
necessaria	necessariamente	Abbr=Yes
necessariamente	necessariamente	_
negativa	negativamente	Abbr=Yes
negativamente	negativamente	_
negativista	negativistamente	Abbr=Yes
negativistamente	negativistamente	_
negligente	negligentemente	Abbr=Yes
negligentemente	negligentemente	_
negra	negramente	Abbr=Yes
negramente	negramente	_
nem	nem	_
nenhures	nenhures	_
nervosa	nervosamente	Abbr=Yes
nervosamente	nervosamente	_
neurologica	neurologicamente	Abbr=Yes
neurologicamente	neurologicamente	_
neurotica	neuroticamente	Abbr=Yes
neuroticamente	neuroticamente	_
neutral	neutralmente	Abbr=Yes
neutralmente	neutralmente	_
niilista	niilistamente	Abbr=Yes
niilistamente	niilistamente	_
nitida	nitidamente	Abbr=Yes
nitidamente	nitidamente	_
niveladora	niveladoramente	Abbr=Yes
niveladoramente	niveladoramente	_
nobre	nobremente	Abbr=Yes
nobremente	nobremente	_
nojenta	nojentamente	Abbr=Yes
nojentamente	nojentamente	_
nomeada	nomeadamente	Abbr=Yes
nomeadamente	nomeadamente	_
nominal	nominalmente	Abbr=Yes
nominalmente	nominalmente	_
normal	normalmente	Abbr=Yes
normalmente	normalmente	_
normativa	normativamente	Abbr=Yes
normativamente	normativamente	_
nostalgica	nostalgicamente	Abbr=Yes
nostalgicamente	nostalgicamente	_
notada	notadamente	Abbr=Yes
notadamente	notadamente	_
notavel	notavelmente	Abbr=Yes
notavelmente	notavelmente	_
notoria	notoriamente	Abbr=Yes
notoriamente	notoriamente	_
nova	novamente	Abbr=Yes
novamente	novamente	_
nuclear	nuclearmente	Abbr=Yes
nuclearmente	nuclearmente	_
nula	nulamente	Abbr=Yes
nulamente	nulamente	_
numerica	numericamente	Abbr=Yes
numericamente	numericamente	_
numerosa	numerosamente	Abbr=Yes
numerosamente	numerosamente	_
nunca	nunca	_
não	não	_
obcecada	obcecadamente	Abbr=Yes
obcecadamente	obcecadamente	_
objetiva	objetivamente	Abbr=Yes
objetivamente	objetivamente	_
obliqua	obliquamente	Abbr=Yes
obliquamente	obliquamente	_
obrigatoria	obrigatoriamente	Abbr=Yes
obrigatoriamente	obrigatoriamente	_
obscena	obscenamente	Abbr=Yes
obscenamente	obscenamente	_
obscura	obscuramente	Abbr=Yes
obscuramente	obscuramente	_
obsequiosa	obsequiosamente	Abbr=Yes
obsequiosamente	obsequiosamente	_
obsessiva	obsessivamente	Abbr=Yes
obsessivamente	obsessivamente	_
obstetrica	obstetricamente	Abbr=Yes
obstetricamente	obstetricamente	_
obstetricia	obstetriciamente	Abbr=Yes
obstetriciamente	obstetriciamente	_
obstinada	obstinadamente	Abbr=Yes
obstinadamente	obstinadamente	_
obstrucionista	obstrucionistamente	Abbr=Yes
obstrucionistamente	obstrucionistamente	_
obvia	obviamente	Abbr=Yes
obviamente	obviamente	_
ocasional	ocasionalmente	Abbr=Yes
ocasionalmente	ocasionalmente	_
occipital	occipitalmente	Abbr=Yes
occipitalmente	occipitalmente	_
ocidental	ocidentalmente	Abbr=Yes
ocidentalmente	ocidentalmente	_
ociosa	ociosamente	Abbr=Yes
ociosamente	ociosamente	_
oclusiva	oclusivamente	Abbr=Yes
oclusivamente	oclusivamente	_
ocultista	ocultistamente	Abbr=Yes
ocultistamente	ocultistamente	_
ocupada	ocupadamente	Abbr=Yes
ocupadamente	ocupadamente	_
ofensiva	ofensivamente	Abbr=Yes
ofensivamente	ofensivamente	_
oficial	oficialmente	Abbr=Yes
oficialmente	oficialmente	_
oficiosa	oficiosamente	Abbr=Yes
oficiosamente	oficiosamente	_
olfativa	olfativamente	Abbr=Yes
olfativamente	olfativamente	_
olimpica	olimpicamente	Abbr=Yes
olimpicamente	olimpicamente	_
onde	onde	_
ondulante	ondulantemente	Abbr=Yes
ondulantemente	ondulantemente	_
onerosa	onerosamente	Abbr=Yes
onerosamente	onerosamente	_
onipotente	onipotentemente	Abbr=Yes
onipotentemente	onipotentemente	_
onomastica	onomasticamente	Abbr=Yes
onomasticamente	onomasticamente	_
ontem	ontem	_
ontologica	ontologicamente	Abbr=Yes
ontologicamente	ontologicamente	_
opaca	opacamente	Abbr=Yes
opacamente	opacamente	_
opcional	opcionalmente	Abbr=Yes
opcionalmente	opcionalmente	_
operacional	operacionalmente	Abbr=Yes
operacionalmente	operacionalmente	_
operativa	operativamente	Abbr=Yes
operativamente	operativamente	_
oportuna	oportunamente	Abbr=Yes
oportunamente	oportunamente	_
oportunista	oportunistamente	Abbr=Yes
oportunistamente	oportunistamente	_
opressiva	opressivamente	Abbr=Yes
opressivamente	opressivamente	_
optativa	optativamente	Abbr=Yes
optativamente	optativamente	_
optica	opticamente	Abbr=Yes
opticamente	opticamente	_
ora	ora	_
oral	oralmente	Abbr=Yes
oralmente	oralmente	_
ordenada	ordenadamente	Abbr=Yes
ordenadamente	ordenadamente	_
ordinaria	ordinariamente	Abbr=Yes
ordinariamente	ordinariamente	_
organica	organicamente	Abbr=Yes
organicamente	organicamente	_
organizada	organizadamente	Abbr=Yes
organizadamente	organizadamente	_
orgastica	orgasticamente	Abbr=Yes
orgasticamente	orgasticamente	_
orgulhosa	orgulhosamente	Abbr=Yes
orgulhosamente	orgulhosamente	_
original	originalmente	Abbr=Yes
originalmente	originalmente	_
originaria	originariamente	Abbr=Yes
originariamente	originariamente	_
ornamental	ornamentalmente	Abbr=Yes
ornamentalmente	ornamentalmente	_
ortodoxa	ortodoxamente	Abbr=Yes
ortodoxamente	ortodoxamente	_
ortogonal	ortogonalmente	Abbr=Yes
ortogonalmente	ortogonalmente	_
oscilante	oscilantemente	Abbr=Yes
oscilantemente	oscilantemente	_
osmotica	osmoticamente	Abbr=Yes
osmoticamente	osmoticamente	_
ostensiva	ostensivamente	Abbr=Yes
ostensivamente	ostensivamente	_
osteoplastica	osteoplasticamente	Abbr=Yes
osteoplasticamente	osteoplasticamente	_
otica	oticamente	Abbr=Yes
oticamente	oticamente	_
otima	otimamente	Abbr=Yes
otimamente	otimamente	_
otimista	otimistamente	Abbr=Yes
otimistamente	otimistamente	_
outrora	outrora	_
outrossim	outrossim	_
paciente	pacientemente	Abbr=Yes
pacientemente	pacientemente	_
pacifica	pacificamente	Abbr=Yes
pacificamente	pacificamente	_
pacifista	pacifistamente	Abbr=Yes
pacifistamente	pacifistamente	_
pactual	pactualmente	Abbr=Yes
pactualmente	pactualmente	_
pactuante	pactuantemente	Abbr=Yes
pactuantemente	pactuantemente	_
palatal	palatalmente	Abbr=Yes
palatalmente	palatalmente	_
paliativa	paliativamente	Abbr=Yes
paliativamente	paliativamente	_
pandega	pandegamente	Abbr=Yes
pandegamente	pandegamente	_
parabolica	parabolicamente	Abbr=Yes
parabolicamente	parabolicamente	_
paradigmatica	paradigmaticamente	Abbr=Yes
paradigmaticamente	paradigmaticamente	_
paradoxal	paradoxalmente	Abbr=Yes
paradoxalmente	paradoxalmente	_
paralela	paralelamente	Abbr=Yes
paralelamente	paralelamente	_
parametrica	parametricamente	Abbr=Yes
parametricamente	parametricamente	_
paravel	paravelmente	Abbr=Yes
paravelmente	paravelmente	_
parca	parcamente	Abbr=Yes
parcamente	parcamente	_
parcial	parcialmente	Abbr=Yes
parcialmente	parcialmente	_
parietal	parietalmente	Abbr=Yes
parietalmente	parietalmente	_
parlamentar	parlamentarmente	Abbr=Yes
parlamentarista	parlamentaristamente	Abbr=Yes
parlamentaristamente	parlamentaristamente	_
parlamentarmente	parlamentarmente	_
paroquial	paroquialmente	Abbr=Yes
paroquialmente	paroquialmente	_
particular	particularmente	Abbr=Yes
particularmente	particularmente	_
partidaria	partidariamente	Abbr=Yes
partidariamente	partidariamente	_
paspalhona	paspalhonamente	Abbr=Yes
paspalhonamente	paspalhonamente	_
passageira	passageiramente	Abbr=Yes
passageiramente	passageiramente	_
passavel	passavelmente	Abbr=Yes
passavelmente	passavelmente	_
passional	passionalmente	Abbr=Yes
passionalmente	passionalmente	_
passiva	passivamente	Abbr=Yes
passivamente	passivamente	_
pastoral	pastoralmente	Abbr=Yes
pastoralmente	pastoralmente	_
patente	patentemente	Abbr=Yes
patentemente	patentemente	_
paternal	paternalmente	Abbr=Yes
paternalista	paternalistamente	Abbr=Yes
paternalistamente	paternalistamente	_
paternalistica	paternalisticamente	Abbr=Yes
paternalisticamente	paternalisticamente	_
paternalmente	paternalmente	_
patetica	pateticamente	Abbr=Yes
pateticamente	pateticamente	_
patriarcal	patriarcalmente	Abbr=Yes
patriarcalmente	patriarcalmente	_
patriota	patriotamente	Abbr=Yes
patriotamente	patriotamente	_
patriotica	patrioticamente	Abbr=Yes
patrioticamente	patrioticamente	_
paulatina	paulatinamente	Abbr=Yes
paulatinamente	paulatinamente	_
pausada	pausadamente	Abbr=Yes
pausadamente	pausadamente	_
pavorosa	pavorosamente	Abbr=Yes
pavorosamente	pavorosamente	_
pecadora	pecadoramente	Abbr=Yes
pecadoramente	pecadoramente	_
pecuaria	pecuariamente	Abbr=Yes
pecuariamente	pecuariamente	_
peculiar	peculiarmente	Abbr=Yes
peculiarmente	peculiarmente	_
pedagogica	pedagogicamente	Abbr=Yes
pedagogicamente	pedagogicamente	_
pedante	pedantemente	Abbr=Yes
pedantemente	pedantemente	_
peitoral	peitoralmente	Abbr=Yes
peitoralmente	peitoralmente	_
pejorativa	pejorativamente	Abbr=Yes
pejorativamente	pejorativamente	_
penal	penalmente	Abbr=Yes
penalmente	penalmente	_
pendular	pendularmente	Abbr=Yes
pendularmente	pendularmente	_
penitencial	penitencialmente	Abbr=Yes
penitencialmente	penitencialmente	_
penitente	penitentemente	Abbr=Yes
penitentemente	penitentemente	_
penosa	penosamente	Abbr=Yes
penosamente	penosamente	_
percentual	percentualmente	Abbr=Yes
percentualmente	percentualmente	_
perceptiva	perceptivamente	Abbr=Yes
perceptivamente	perceptivamente	_
perceptivel	perceptivelmente	Abbr=Yes
perceptivelmente	perceptivelmente	_
perdida	perdidamente	Abbr=Yes
perdidamente	perdidamente	_
peremptoria	peremptoriamente	Abbr=Yes
peremptoriamente	peremptoriamente	_
perene	perenemente	Abbr=Yes
perenemente	perenemente	_
perfeita	perfeitamente	Abbr=Yes
perfeitamente	perfeitamente	_
perfida	perfidamente	Abbr=Yes
perfidamente	perfidamente	_
perfunctoria	perfunctoriamente	Abbr=Yes
perfunctoriamente	perfunctoriamente	_
perfurante	perfurantemente	Abbr=Yes
perfurantemente	perfurantemente	_
pericial	pericialmente	Abbr=Yes
pericialmente	pericialmente	_
periferica	perifericamente	Abbr=Yes
perifericamente	perifericamente	_
perigosa	perigosamente	Abbr=Yes
perigosamente	perigosamente	_
periodica	periodicamente	Abbr=Yes
periodicamente	periodicamente	_
permanente	permanentemente	Abbr=Yes
permanentemente	permanentemente	_
permeio	permeio	_
perniciosa	perniciosamente	Abbr=Yes
perniciosamente	perniciosamente	_
perpendicular	perpendicularmente	Abbr=Yes
perpendicularmente	perpendicularmente	_
perpetua	perpetuamente	Abbr=Yes
perpetuada	perpetuadamente	Abbr=Yes
perpetuadamente	perpetuadamente	_
perpetuadora	perpetuadoramente	Abbr=Yes
perpetuadoramente	perpetuadoramente	_
perpetuamente	perpetuamente	_
perseverante	perseverantemente	Abbr=Yes
perseverantemente	perseverantemente	_
persistente	persistentemente	Abbr=Yes
persistentemente	persistentemente	_
perspectiva	perspectivamente	Abbr=Yes
perspectivamente	perspectivamente	_
perspicaz	perspicazmente	Abbr=Yes
perspicazmente	perspicazmente	_
persuasiva	persuasivamente	Abbr=Yes
persuasivamente	persuasivamente	_
pertencente	pertencentemente	Abbr=Yes
pertencentemente	pertencentemente	_
pertinente	pertinentemente	Abbr=Yes
pertinentemente	pertinentemente	_
pertinho	pertinho	_
perto	perto	_
perversa	perversamente	Abbr=Yes
perversamente	perversamente	_
pesada	pesadamente	Abbr=Yes
pesadamente	pesadamente	_
pessima	pessimamente	Abbr=Yes
pessimamente	pessimamente	_
pessimista	pessimistamente	Abbr=Yes
pessimistamente	pessimistamente	_
pessoal	pessoalmente	Abbr=Yes
pessoalmente	pessoalmente	_
petulante	petulantemente	Abbr=Yes
petulantemente	petulantemente	_
pia	piamente	Abbr=Yes
piamente	piamente	_
picante	picantemente	Abbr=Yes
picantemente	picantemente	_
piedosa	piedosamente	Abbr=Yes
piedosamente	piedosamente	_
pilantra	pilantramente	Abbr=Yes
pilantramente	pilantramente	_
pioneira	pioneiramente	Abbr=Yes
pioneiramente	pioneiramente	_
pior	pior	_
pitoresca	pitorescamente	Abbr=Yes
pitorescamente	pitorescamente	_
placida	placidamente	Abbr=Yes
placidamente	placidamente	_
planetaria	planetariamente	Abbr=Yes
planetariamente	planetariamente	_
plastica	plasticamente	Abbr=Yes
plasticamente	plasticamente	_
platonica	platonicamente	Abbr=Yes
platonicamente	platonicamente	_
plausivel	plausivelmente	Abbr=Yes
plausivelmente	plausivelmente	_
plena	plenamente	Abbr=Yes
plenamente	plenamente	_
pluvial	pluvialmente	Abbr=Yes
pluvialmente	pluvialmente	_
pneumatica	pneumaticamente	Abbr=Yes
pneumaticamente	pneumaticamente	_
pobre	pobremente	Abbr=Yes
pobremente	pobremente	_
poderosa	poderosamente	Abbr=Yes
poderosamente	poderosamente	_
poetica	poeticamente	Abbr=Yes
poeticamente	poeticamente	_
polemica	polemicamente	Abbr=Yes
polemicamente	polemicamente	_
policial	policialmente	Abbr=Yes
policialmente	policialmente	_
polida	polidamente	Abbr=Yes
polidamente	polidamente	_
polifonica	polifonicamente	Abbr=Yes
polifonicamente	polifonicamente	_
poligonal	poligonalmente	Abbr=Yes
poligonalmente	poligonalmente	_
politica	politicamente	Abbr=Yes
politicamente	politicamente	_
polvorosa	polvorosamente	Abbr=Yes
polvorosamente	polvorosamente	_
pomposa	pomposamente	Abbr=Yes
pomposamente	pomposamente	_
ponderativa	ponderativamente	Abbr=Yes
ponderativamente	ponderativamente	_
pontifical	pontificalmente	Abbr=Yes
pontificalmente	pontificalmente	_
pontual	pontualmente	Abbr=Yes
pontualmente	pontualmente	_
popular	popularmente	Abbr=Yes
popularmente	popularmente	_
porca	porcamente	Abbr=Yes
porcamente	porcamente	_
pormenorizada	pormenorizadamente	Abbr=Yes
pormenorizadamente	pormenorizadamente	_
pornografica	pornograficamente	Abbr=Yes
pornograficamente	pornograficamente	_
portenha	portenhamente	Abbr=Yes
portenhamente	portenhamente	_
porventura	porventura	_
positiva	positivamente	Abbr=Yes
positivamente	positivamente	_
positivista	positivistamente	Abbr=Yes
positivistamente	positivistamente	_
possivel	possivelmente	Abbr=Yes
possivelmente	possivelmente	_
posterior	posteriormente	Abbr=Yes
posteriormente	posteriormente	_
postuma	postumamente	Abbr=Yes
postumamente	postumamente	_
potencial	potencialmente	Abbr=Yes
potencialmente	potencialmente	_
pouco	pouco	_
pouquinho	pouquinho	_
pouquíssimo	pouquíssimo	_
pragmatica	pragmaticamente	Abbr=Yes
pragmaticamente	pragmaticamente	_
pratica	praticamente	Abbr=Yes
praticamente	praticamente	_
praticavel	praticavelmente	Abbr=Yes
praticavelmente	praticavelmente	_
prazenteira	prazenteiramente	Abbr=Yes
prazenteiramente	prazenteiramente	_
prazerosa	prazerosamente	Abbr=Yes
prazerosamente	prazerosamente	_
preambularmente	preambularmente	_
precaria	precariamente	Abbr=Yes
precariamente	precariamente	_
precavida	precavidamente	Abbr=Yes
precavidamente	precavidamente	_
precedente	precedentemente	Abbr=Yes
precedentemente	precedentemente	_
preciosa	preciosamente	Abbr=Yes
preciosamente	preciosamente	_
precipitada	precipitadamente	Abbr=Yes
precipitadamente	precipitadamente	_
precipitante	precipitantemente	Abbr=Yes
precipitantemente	precipitantemente	_
precisa	precisamente	Abbr=Yes
precisamente	precisamente	_
precoce	precocemente	Abbr=Yes
precocemente	precocemente	_
preconceituosa	preconceituosamente	Abbr=Yes
preconceituosamente	preconceituosamente	_
predeterminante	predeterminantemente	Abbr=Yes
predeterminantemente	predeterminantemente	_
predicante	predicantemente	Abbr=Yes
predicantemente	predicantemente	_
predominante	predominantemente	Abbr=Yes
predominantemente	predominantemente	_
preferencial	preferencialmente	Abbr=Yes
preferencialmente	preferencialmente	_
preferente	preferentemente	Abbr=Yes
preferentemente	preferentemente	_
preferivel	preferivelmente	Abbr=Yes
preferivelmente	preferivelmente	_
preguiçosa	preguiçosamente	Abbr=Yes
preguiçosamente	preguiçosamente	_
prejudicial	prejudicialmente	Abbr=Yes
prejudicialmente	prejudicialmente	_
preliminar	preliminarmente	Abbr=Yes
preliminarmente	preliminarmente	_
prematura	prematuramente	Abbr=Yes
prematuramente	prematuramente	_
preponderante	preponderantemente	Abbr=Yes
preponderantemente	preponderantemente	_
presencial	presencialmente	Abbr=Yes
presencialmente	presencialmente	_
presente	presentemente	Abbr=Yes
presentemente	presentemente	_
pressurosa	pressurosamente	Abbr=Yes
pressurosamente	pressurosamente	_
presta	prestamente	Abbr=Yes
prestamente	prestamente	_
preste	prestemente	Abbr=Yes
prestemente	prestemente	_
prestes	prestesmente	Abbr=Yes
prestesmente	prestesmente	_
prestidigitalmente	prestidigitalmente	_
prestigiosa	prestigiosamente	Abbr=Yes
prestigiosamente	prestigiosamente	_
presumida	presumidamente	Abbr=Yes
presumidamente	presumidamente	_
presumivel	presumivelmente	Abbr=Yes
presumivelmente	presumivelmente	_
presuntiva	presuntivamente	Abbr=Yes
presuntivamente	presuntivamente	_
presunçosa	presunçosamente	Abbr=Yes
presunçosamente	presunçosamente	_
pretensa	pretensamente	Abbr=Yes
pretensamente	pretensamente	_
pretensiosa	pretensiosamente	Abbr=Yes
pretensiosamente	pretensiosamente	_
preventiva	preventivamente	Abbr=Yes
preventivamente	preventivamente	_
previa	previamente	Abbr=Yes
previamente	previamente	_
previsivel	previsivelmente	Abbr=Yes
previsivelmente	previsivelmente	_
primaria	primariamente	Abbr=Yes
primariamente	primariamente	_
primeira	primeiramente	Abbr=Yes
primeiramente	primeiramente	_
primitiva	primitivamente	Abbr=Yes
primitivamente	primitivamente	_
primordial	primordialmente	Abbr=Yes
primordialmente	primordialmente	_
primorosa	primorosamente	Abbr=Yes
primorosamente	primorosamente	_
principal	principalmente	Abbr=Yes
principalmente	principalmente	_
principiante	principiantemente	Abbr=Yes
principiantemente	principiantemente	_
prioritaria	prioritariamente	Abbr=Yes
prioritariamente	prioritariamente	_
privada	privadamente	Abbr=Yes
privadamente	privadamente	_
privativa	privativamente	Abbr=Yes
privativamente	privativamente	_
privilegiada	privilegiadamente	Abbr=Yes
privilegiadamente	privilegiadamente	_
probabilistica	probabilisticamente	Abbr=Yes
probabilisticamente	probabilisticamente	_
problematica	problematicamente	Abbr=Yes
problematicamente	problematicamente	_
processual	processualmente	Abbr=Yes
processualmente	processualmente	_
prodiga	prodigamente	Abbr=Yes
prodigamente	prodigamente	_
prodigiosa	prodigiosamente	Abbr=Yes
prodigiosamente	prodigiosamente	_
produtiva	produtivamente	Abbr=Yes
produtivamente	produtivamente	_
profanada	profanadamente	Abbr=Yes
profanadamente	profanadamente	_
profetica	profeticamente	Abbr=Yes
profeticamente	profeticamente	_
proficua	proficuamente	Abbr=Yes
proficuamente	proficuamente	_
profissional	profissionalmente	Abbr=Yes
profissionalmente	profissionalmente	_
profunda	profundamente	Abbr=Yes
profundamente	profundamente	_
profusa	profusamente	Abbr=Yes
profusamente	profusamente	_
programatica	programaticamente	Abbr=Yes
programaticamente	programaticamente	_
progressiva	progressivamente	Abbr=Yes
progressivamente	progressivamente	_
projetiva	projetivamente	Abbr=Yes
projetivamente	projetivamente	_
proletaria	proletariamente	Abbr=Yes
proletariamente	proletariamente	_
promiscua	promiscuamente	Abbr=Yes
promiscuamente	promiscuamente	_
promocional	promocionalmente	Abbr=Yes
promocionalmente	promocionalmente	_
pronta	prontamente	Abbr=Yes
prontamente	prontamente	_
pronunciada	pronunciadamente	Abbr=Yes
pronunciadamente	pronunciadamente	_
proporcional	proporcionalmente	Abbr=Yes
proporcionalmente	proporcionalmente	_
propositada	propositadamente	Abbr=Yes
propositadamente	propositadamente	_
proposital	propositalmente	Abbr=Yes
propositalmente	propositalmente	_
propria	propriamente	Abbr=Yes
propriamente	propriamente	_
prosaica	prosaicamente	Abbr=Yes
prosaicamente	prosaicamente	_
prospectiva	prospectivamente	Abbr=Yes
prospectivamente	prospectivamente	_
prospera	prosperamente	Abbr=Yes
prosperamente	prosperamente	_
protecionista	protecionistamente	Abbr=Yes
protecionistamente	protecionistamente	_
protetora	protetoramente	Abbr=Yes
protetoramente	protetoramente	_
protocolar	protocolarmente	Abbr=Yes
protocolarmente	protocolarmente	_
provada	provadamente	Abbr=Yes
provadamente	provadamente	_
provavel	provavelmente	Abbr=Yes
provavelmente	provavelmente	_
proverbial	proverbialmente	Abbr=Yes
proverbialmente	proverbialmente	_
providenciada	providenciadamente	Abbr=Yes
providenciadamente	providenciadamente	_
providencial	providencialmente	Abbr=Yes
providencialmente	providencialmente	_
providenciosamente	providenciosamente	_
provincial	provincialmente	Abbr=Yes
provincialmente	provincialmente	_
provinciana	provincianamente	Abbr=Yes
provincianamente	provincianamente	_
provisoria	provisoriamente	Abbr=Yes
provisoriamente	provisoriamente	_
provocativa	provocativamente	Abbr=Yes
provocativamente	provocativamente	_
proxima	proximamente	Abbr=Yes
proximamente	proximamente	_
prudente	prudentemente	Abbr=Yes
prudentemente	prudentemente	_
próximo	próximo	_
psicanalitica	psicanaliticamente	Abbr=Yes
psicanaliticamente	psicanaliticamente	_
psicodinamica	psicodinamicamente	Abbr=Yes
psicodinamicamente	psicodinamicamente	_
psicofisica	psicofisicamente	Abbr=Yes
psicofisicamente	psicofisicamente	_
psicologica	psicologicamente	Abbr=Yes
psicologicamente	psicologicamente	_
psicotecnica	psicotecnicamente	Abbr=Yes
psicotecnicamente	psicotecnicamente	_
psiquiatrica	psiquiatricamente	Abbr=Yes
psiquiatricamente	psiquiatricamente	_
psiquica	psiquicamente	Abbr=Yes
psiquicamente	psiquicamente	_
publica	publicamente	Abbr=Yes
publicamente	publicamente	_
publicitaria	publicitariamente	Abbr=Yes
publicitariamente	publicitariamente	_
pudica	pudicamente	Abbr=Yes
pudicamente	pudicamente	_
pungente	pungentemente	Abbr=Yes
pungentemente	pungentemente	_
punitiva	punitivamente	Abbr=Yes
punitivamente	punitivamente	_
pura	puramente	Abbr=Yes
puramente	puramente	_
purpura	purpuramente	Abbr=Yes
purpuramente	purpuramente	_
pusilanime	pusilanimemente	Abbr=Yes
pusilanimemente	pusilanimemente	_
qualificada	qualificadamente	Abbr=Yes
qualificadamente	qualificadamente	_
qualitativa	qualitativamente	Abbr=Yes
qualitativamente	qualitativamente	_
quando	quando	_
quantitativa	quantitativamente	Abbr=Yes
quantitativamente	quantitativamente	_
quanto	quanto	_
quase	quase	_
quilometrica	quilometricamente	Abbr=Yes
quilometricamente	quilometricamente	_
quimerica	quimericamente	Abbr=Yes
quimericamente	quimericamente	_
quimica	quimicamente	Abbr=Yes
quimicamente	quimicamente	_
quinquenal	quinquenalmente	Abbr=Yes
quinquenalmente	quinquenalmente	_
quinzenal	quinzenalmente	Abbr=Yes
quinzenalmente	quinzenalmente	_
quixotesca	quixotescamente	Abbr=Yes
quixotescamente	quixotescamente	_
quiçá	quiçá	_
quotidiana	quotidianamente	Abbr=Yes
quotidianamente	quotidianamente	_
quão	quão	_
racial	racialmente	Abbr=Yes
racialmente	racialmente	_
racional	racionalmente	Abbr=Yes
racionalista	racionalistamente	Abbr=Yes
racionalistamente	racionalistamente	_
racionalmente	racionalmente	_
radial	radialmente	Abbr=Yes
radialmente	radialmente	_
radiante	radiantemente	Abbr=Yes
radiantemente	radiantemente	_
radiativa	radiativamente	Abbr=Yes
radiativamente	radiativamente	_
radical	radicalmente	Abbr=Yes
radicalista	radicalistamente	Abbr=Yes
radicalistamente	radicalistamente	_
radicalmente	radicalmente	_
radioativa	radioativamente	Abbr=Yes
radioativamente	radioativamente	_
raivosa	raivosamente	Abbr=Yes
raivosamente	raivosamente	_
randomica	randomicamente	Abbr=Yes
randomicamente	randomicamente	_
ranzinza	ranzinzamente	Abbr=Yes
ranzinzamente	ranzinzamente	_
rançosa	rançosamente	Abbr=Yes
rançosamente	rançosamente	_
rapida	rapidamente	Abbr=Yes
rapidamente	rapidamente	_
rara	raramente	Abbr=Yes
raramente	raramente	_
rasa	rasamente	Abbr=Yes
rasamente	rasamente	_
rasgada	rasgadamente	Abbr=Yes
rasgadamente	rasgadamente	_
rasteira	rasteiramente	Abbr=Yes
rasteiramente	rasteiramente	_
rastejante	rastejantemente	Abbr=Yes
rastejantemente	rastejantemente	_
razoavel	razoavelmente	Abbr=Yes
razoavelmente	razoavelmente	_
reabitacionalmente	reabitacionalmente	_
readequadamente	readequadamente	_
real	realmente	Abbr=Yes
realista	realistamente	Abbr=Yes
realistamente	realistamente	_
realmente	realmente	_
rebarbativa	rebarbativamente	Abbr=Yes
rebarbativamente	rebarbativamente	_
rebelde	rebeldemente	Abbr=Yes
rebeldemente	rebeldemente	_
recatada	recatadamente	Abbr=Yes
recatadamente	recatadamente	_
recente	recentemente	Abbr=Yes
recentemente	recentemente	_
recidiva	recidivamente	Abbr=Yes
recidivamente	recidivamente	_
reciproca	reciprocamente	Abbr=Yes
reciprocamente	reciprocamente	_
recitativa	recitativamente	Abbr=Yes
recitativamente	recitativamente	_
reclinada	reclinadamente	Abbr=Yes
reclinadamente	reclinadamente	_
reconfortante	reconfortantemente	Abbr=Yes
reconfortantemente	reconfortantemente	_
reconhecida	reconhecidamente	Abbr=Yes
reconhecidamente	reconhecidamente	_
recorde	recordemente	Abbr=Yes
recordemente	recordemente	_
recorrente	recorrentemente	Abbr=Yes
recorrentemente	recorrentemente	_
recuperativa	recuperativamente	Abbr=Yes
recuperativamente	recuperativamente	_
recursiva	recursivamente	Abbr=Yes
recursivamente	recursivamente	_
recém	recém	_
redentora	redentoramente	Abbr=Yes
redentoramente	redentoramente	_
redonda	redondamente	Abbr=Yes
redondamente	redondamente	_
redundante	redundantemente	Abbr=Yes
redundantemente	redundantemente	_
referencial	referencialmente	Abbr=Yes
referencialmente	referencialmente	_
referente	referentemente	Abbr=Yes
referentemente	referentemente	_
refinadora	refinadoramente	Abbr=Yes
refinadoramente	refinadoramente	_
refletida	refletidamente	Abbr=Yes
refletidamente	refletidamente	_
reflexa	reflexamente	Abbr=Yes
reflexamente	reflexamente	_
regateira	regateiramente	Abbr=Yes
regateiramente	regateiramente	_
regenerante	regenerantemente	Abbr=Yes
regenerantemente	regenerantemente	_
regia	regiamente	Abbr=Yes
regiamente	regiamente	_
regimental	regimentalmente	Abbr=Yes
regimentalmente	regimentalmente	_
regional	regionalmente	Abbr=Yes
regionalista	regionalistamente	Abbr=Yes
regionalistamente	regionalistamente	_
regionalmente	regionalmente	_
regressiva	regressivamente	Abbr=Yes
regressivamente	regressivamente	_
regular	regularmente	Abbr=Yes
regularmente	regularmente	_
reincidente	reincidentemente	Abbr=Yes
reincidentemente	reincidentemente	_
reiterada	reiteradamente	Abbr=Yes
reiteradamente	reiteradamente	_
reiterativa	reiterativamente	Abbr=Yes
reiterativamente	reiterativamente	_
relativa	relativamente	Abbr=Yes
relativamente	relativamente	_
relativistica	relativisticamente	Abbr=Yes
relativisticamente	relativisticamente	_
relevante	relevantemente	Abbr=Yes
relevantemente	relevantemente	_
religiosa	religiosamente	Abbr=Yes
religiosamente	religiosamente	_
relutante	relutantemente	Abbr=Yes
relutantemente	relutantemente	_
remanescente	remanescentemente	Abbr=Yes
remanescentemente	remanescentemente	_
remota	remotamente	Abbr=Yes
remotamente	remotamente	_
renovada	renovadamente	Abbr=Yes
renovadamente	renovadamente	_
rente	rente	_
repentina	repentinamente	Abbr=Yes
repentinamente	repentinamente	_
repetida	repetidamente	Abbr=Yes
repetidamente	repetidamente	_
repetidora	repetidoramente	Abbr=Yes
repetidoramente	repetidoramente	_
repetitiva	repetitivamente	Abbr=Yes
repetitivamente	repetitivamente	_
reprodutiva	reprodutivamente	Abbr=Yes
reprodutivamente	reprodutivamente	_
republicana	republicanamente	Abbr=Yes
republicanamente	republicanamente	_
reservada	reservadamente	Abbr=Yes
reservadamente	reservadamente	_
residual	residualmente	Abbr=Yes
residualmente	residualmente	_
resignada	resignadamente	Abbr=Yes
resignadamente	resignadamente	_
resmungona	resmungonamente	Abbr=Yes
resmungonamente	resmungonamente	_
resoluta	resolutamente	Abbr=Yes
resolutamente	resolutamente	_
respectiva	respectivamente	Abbr=Yes
respectivamente	respectivamente	_
respeitosa	respeitosamente	Abbr=Yes
respeitosamente	respeitosamente	_
respondona	respondonamente	Abbr=Yes
respondonamente	respondonamente	_
responsavel	responsavelmente	Abbr=Yes
responsavelmente	responsavelmente	_
ressonante	ressonantemente	Abbr=Yes
ressonantemente	ressonantemente	_
restaurante	restaurantemente	Abbr=Yes
restaurantemente	restaurantemente	_
restrita	restritamente	Abbr=Yes
restritamente	restritamente	_
restritiva	restritivamente	Abbr=Yes
restritivamente	restritivamente	_
resumida	resumidamente	Abbr=Yes
resumidamente	resumidamente	_
reta	retamente	Abbr=Yes
retamente	retamente	_
retificadora	retificadoramente	Abbr=Yes
retificadoramente	retificadoramente	_
retilinea	retilineamente	Abbr=Yes
retilineamente	retilineamente	_
retirada	retiradamente	Abbr=Yes
retiradamente	retiradamente	_
retorica	retoricamente	Abbr=Yes
retoricamente	retoricamente	_
retro	retro	_
retroativa	retroativamente	Abbr=Yes
retroativamente	retroativamente	_
retrospectiva	retrospectivamente	Abbr=Yes
retrospectivamente	retrospectivamente	_
reumatica	reumaticamente	Abbr=Yes
reumaticamente	reumaticamente	_
reverenciosamente	reverenciosamente	_
reverente	reverentemente	Abbr=Yes
reverentemente	reverentemente	_
revoltante	revoltantemente	Abbr=Yes
revoltantemente	revoltantemente	_
revolucionaria	revolucionariamente	Abbr=Yes
revolucionariamente	revolucionariamente	_
rezingona	rezingonamente	Abbr=Yes
rezingonamente	rezingonamente	_
rica	ricamente	Abbr=Yes
ricamente	ricamente	_
ridicula	ridiculamente	Abbr=Yes
ridiculamente	ridiculamente	_
rigida	rigidamente	Abbr=Yes
rigidamente	rigidamente	_
rigorosa	rigorosamente	Abbr=Yes
rigorosamente	rigorosamente	_
risivel	risivelmente	Abbr=Yes
risivelmente	risivelmente	_
rispida	rispidamente	Abbr=Yes
rispidamente	rispidamente	_
ritmica	ritmicamente	Abbr=Yes
ritmicamente	ritmicamente	_
ritual	ritualmente	Abbr=Yes
ritualista	ritualistamente	Abbr=Yes
ritualistamente	ritualistamente	_
ritualistica	ritualisticamente	Abbr=Yes
ritualisticamente	ritualisticamente	_
ritualmente	ritualmente	_
rival	rivalmente	Abbr=Yes
rivalmente	rivalmente	_
romantica	romanticamente	Abbr=Yes
romanticamente	romanticamente	_
rotativa	rotativamente	Abbr=Yes
rotativamente	rotativamente	_
rotineira	rotineiramente	Abbr=Yes
rotineiramente	rotineiramente	_
rotunda	rotundamente	Abbr=Yes
rotundamente	rotundamente	_
rude	rudemente	Abbr=Yes
rudemente	rudemente	_
rudimentar	rudimentarmente	Abbr=Yes
rudimentarmente	rudimentarmente	_
ruidosa	ruidosamente	Abbr=Yes
ruidosamente	ruidosamente	_
ruminante	ruminantemente	Abbr=Yes
ruminantemente	ruminantemente	_
rural	ruralmente	Abbr=Yes
ruralista	ruralistamente	Abbr=Yes
ruralistamente	ruralistamente	_
ruralisticamente	ruralisticamente	_
ruralmente	ruralmente	_
rustica	rusticamente	Abbr=Yes
rusticamente	rusticamente	_
rutilante	rutilantemente	Abbr=Yes
rutilantemente	rutilantemente	_
rápido	rápido	_
sabia	sabiamente	Abbr=Yes
sabiamente	sabiamente	_
sabida	sabidamente	Abbr=Yes
sabidamente	sabidamente	_
saborosa	saborosamente	Abbr=Yes
saborosamente	saborosamente	_
sacana	sacanamente	Abbr=Yes
sacanamente	sacanamente	_
sacramental	sacramentalmente	Abbr=Yes
sacramentalmente	sacramentalmente	_
sacrificante	sacrificantemente	Abbr=Yes
sacrificantemente	sacrificantemente	_
sadia	sadiamente	Abbr=Yes
sadiamente	sadiamente	_
sadica	sadicamente	Abbr=Yes
sadicamente	sadicamente	_
safada	safadamente	Abbr=Yes
safadamente	safadamente	_
sagaz	sagazmente	Abbr=Yes
sagazmente	sagazmente	_
sagrada	sagradamente	Abbr=Yes
sagradamente	sagradamente	_
saliente	salientemente	Abbr=Yes
salientemente	salientemente	_
salutar	salutarmente	Abbr=Yes
salutarmente	salutarmente	_
sangrenta	sangrentamente	Abbr=Yes
sangrentamente	sangrentamente	_
sanguinaria	sanguinariamente	Abbr=Yes
sanguinariamente	sanguinariamente	_
sapeca	sapecamente	Abbr=Yes
sapecamente	sapecamente	_
sarcastica	sarcasticamente	Abbr=Yes
sarcasticamente	sarcasticamente	_
sardonica	sardonicamente	Abbr=Yes
sardonicamente	sardonicamente	_
satirica	satiricamente	Abbr=Yes
satiricamente	satiricamente	_
satisfatoria	satisfatoriamente	Abbr=Yes
satisfatoriamente	satisfatoriamente	_
saudavel	saudavelmente	Abbr=Yes
saudavelmente	saudavelmente	_
saudosa	saudosamente	Abbr=Yes
saudosamente	saudosamente	_
saudosista	saudosistamente	Abbr=Yes
saudosistamente	saudosistamente	_
sazonal	sazonalmente	Abbr=Yes
sazonalmente	sazonalmente	_
seca	secamente	Abbr=Yes
secamente	secamente	_
secreta	secretamente	Abbr=Yes
secretamente	secretamente	_
secular	secularmente	Abbr=Yes
secularmente	secularmente	_
secundaria	secundariamente	Abbr=Yes
secundariamente	secundariamente	_
sedativa	sedativamente	Abbr=Yes
sedativamente	sedativamente	_
sedutora	sedutoramente	Abbr=Yes
sedutoramente	sedutoramente	_
seguida	seguidamente	Abbr=Yes
seguidamente	seguidamente	_
segunda	segundamente	Abbr=Yes
segundamente	segundamente	_
segura	seguramente	Abbr=Yes
seguramente	seguramente	_
seleta	seletamente	Abbr=Yes
seletamente	seletamente	_
seletiva	seletivamente	Abbr=Yes
seletivamente	seletivamente	_
selvagem	selvagemmente	Abbr=Yes
selvagemmente	selvagemmente	_
semanal	semanalmente	Abbr=Yes
semanalmente	semanalmente	_
semantica	semanticamente	Abbr=Yes
semanticamente	semanticamente	_
semelhante	semelhantemente	Abbr=Yes
semelhantemente	semelhantemente	_
semestral	semestralmente	Abbr=Yes
semestralmente	semestralmente	_
sempre	sempre	_
sensacional	sensacionalmente	Abbr=Yes
sensacionalmente	sensacionalmente	_
sensata	sensatamente	Abbr=Yes
sensatamente	sensatamente	_
sensitiva	sensitivamente	Abbr=Yes
sensitivamente	sensitivamente	_
sensivel	sensivelmente	Abbr=Yes
sensivelmente	sensivelmente	_
sensorial	sensorialmente	Abbr=Yes
sensorialmente	sensorialmente	_
sensual	sensualmente	Abbr=Yes
sensualista	sensualistamente	Abbr=Yes
sensualistamente	sensualistamente	_
sensualistica	sensualisticamente	Abbr=Yes
sensualisticamente	sensualisticamente	_
sensualmente	sensualmente	_
sentimental	sentimentalmente	Abbr=Yes
sentimentalista	sentimentalistamente	Abbr=Yes
sentimentalistamente	sentimentalistamente	_
sentimentalmente	sentimentalmente	_
separada	separadamente	Abbr=Yes
separadamente	separadamente	_
sequencial	sequencialmente	Abbr=Yes
sequencialmente	sequencialmente	_
sequer	sequer	_
serelepe	serelepemente	Abbr=Yes
serelepemente	serelepemente	_
serena	serenamente	Abbr=Yes
serenamente	serenamente	_
seria	seriamente	Abbr=Yes
serial	serialmente	Abbr=Yes
serialmente	serialmente	_
seriamente	seriamente	_
serodia	serodiamente	Abbr=Yes
serodiamente	serodiamente	_
sertaneja	sertanejamente	Abbr=Yes
sertanejamente	sertanejamente	_
servil	servilmente	Abbr=Yes
servilmente	servilmente	_
setentrional	setentrionalmente	Abbr=Yes
setentrionalmente	setentrionalmente	_
setorial	setorialmente	Abbr=Yes
setorialmente	setorialmente	_
severa	severamente	Abbr=Yes
severamente	severamente	_
sexual	sexualmente	Abbr=Yes
sexualmente	sexualmente	_
sibilante	sibilantemente	Abbr=Yes
sibilantemente	sibilantemente	_
sic	sic	_
sigilosa	sigilosamente	Abbr=Yes
sigilosamente	sigilosamente	_
significante	significantemente	Abbr=Yes
significantemente	significantemente	_
significativa	significativamente	Abbr=Yes
significativamente	significativamente	_
silenciosa	silenciosamente	Abbr=Yes
silenciosamente	silenciosamente	_
sim	sim	_
simbolica	simbolicamente	Abbr=Yes
simbolicamente	simbolicamente	_
simetrica	simetricamente	Abbr=Yes
simetricamente	simetricamente	_
similar	similarmente	Abbr=Yes
similarmente	similarmente	_
simpatica	simpaticamente	Abbr=Yes
simpaticamente	simpaticamente	_
simples	simples	_
simples	simplesmente	Abbr=Yes
simplesmente	simplesmente	_
simplificadora	simplificadoramente	Abbr=Yes
simplificadoramente	simplificadoramente	_
simploria	simploriamente	Abbr=Yes
simploriamente	simploriamente	_
simultanea	simultaneamente	Abbr=Yes
simultaneamente	simultaneamente	_
sincera	sinceramente	Abbr=Yes
sinceramente	sinceramente	_
sincronica	sincronicamente	Abbr=Yes
sincronicamente	sincronicamente	_
sincronista	sincronistamente	Abbr=Yes
sincronistamente	sincronistamente	_
sincronisticamente	sincronisticamente	_
sindicalista	sindicalistamente	Abbr=Yes
sindicalistamente	sindicalistamente	_
sinfonica	sinfonicamente	Abbr=Yes
sinfonicamente	sinfonicamente	_
singela	singelamente	Abbr=Yes
singelamente	singelamente	_
singular	singularmente	Abbr=Yes
singularmente	singularmente	_
sinistra	sinistramente	Abbr=Yes
sinistramente	sinistramente	_
sinonimica	sinonimicamente	Abbr=Yes
sinonimicamente	sinonimicamente	_
sintatica	sintaticamente	Abbr=Yes
sintaticamente	sintaticamente	_
sintetica	sinteticamente	Abbr=Yes
sinteticamente	sinteticamente	_
sintomatica	sintomaticamente	Abbr=Yes
sintomaticamente	sintomaticamente	_
sinuosa	sinuosamente	Abbr=Yes
sinuosamente	sinuosamente	_
sistematica	sistematicamente	Abbr=Yes
sistematicamente	sistematicamente	_
sobeja	sobejamente	Abbr=Yes
sobejamente	sobejamente	_
soberana	soberanamente	Abbr=Yes
soberanamente	soberanamente	_
soberba	soberbamente	Abbr=Yes
soberbamente	soberbamente	_
sobranceiro	sobranceiro	_
sobremaneira	sobremaneira	_
sobremodo	sobremodo	_
sobrenatural	sobrenaturalmente	Abbr=Yes
sobrenaturalmente	sobrenaturalmente	_
sobressalente	sobressalentemente	Abbr=Yes
sobressalentemente	sobressalentemente	_
sobresselente	sobresselentemente	Abbr=Yes
sobresselentemente	sobresselentemente	_
sobretudo	sobretudo	_
sobria	sobriamente	Abbr=Yes
sobriamente	sobriamente	_
social	socialmente	Abbr=Yes
socialista	socialistamente	Abbr=Yes
socialistamente	socialistamente	_
socialistica	socialisticamente	Abbr=Yes
socialisticamente	socialisticamente	_
socialmente	socialmente	_
sociavel	sociavelmente	Abbr=Yes
sociavelmente	sociavelmente	_
sociologica	sociologicamente	Abbr=Yes
sociologicamente	sociologicamente	_
sofistica	sofisticamente	Abbr=Yes
sofisticamente	sofisticamente	_
sofrega	sofregamente	Abbr=Yes
sofregamente	sofregamente	_
sofrivel	sofrivelmente	Abbr=Yes
sofrivelmente	sofrivelmente	_
solene	solenemente	Abbr=Yes
solenemente	solenemente	_
solerte	solertemente	Abbr=Yes
solertemente	solertemente	_
solida	solidamente	Abbr=Yes
solidamente	solidamente	_
solidaria	solidariamente	Abbr=Yes
solidariamente	solidariamente	_
solitaria	solitariamente	Abbr=Yes
solitariamente	solitariamente	_
soluçante	soluçantemente	Abbr=Yes
soluçantemente	soluçantemente	_
somente	somente	_
sonhadora	sonhadoramente	Abbr=Yes
sonhadoramente	sonhadoramente	_
sonolenta	sonolentamente	Abbr=Yes
sonolentamente	sonolentamente	_
sonora	sonoramente	Abbr=Yes
sonoramente	sonoramente	_
sordida	sordidamente	Abbr=Yes
sordidamente	sordidamente	_
sorrateira	sorrateiramente	Abbr=Yes
sorrateiramente	sorrateiramente	_
soturna	soturnamente	Abbr=Yes
soturnamente	soturnamente	_
sovina	sovinamente	Abbr=Yes
sovinamente	sovinamente	_
suave	suavemente	Abbr=Yes
suavemente	suavemente	_
subconsciente	subconscientemente	Abbr=Yes
subconscientemente	subconscientemente	_
subdesenvolvida	subdesenvolvidamente	Abbr=Yes
subdesenvolvidamente	subdesenvolvidamente	_
subita	subitamente	Abbr=Yes
subitamente	subitamente	_
subjetiva	subjetivamente	Abbr=Yes
subjetivamente	subjetivamente	_
sublime	sublimemente	Abbr=Yes
sublimemente	sublimemente	_
subliminar	subliminarmente	Abbr=Yes
subliminarmente	subliminarmente	_
subsequente	subsequentemente	Abbr=Yes
subsequentemente	subsequentemente	_
subsidiaria	subsidiariamente	Abbr=Yes
subsidiariamente	subsidiariamente	_
substancial	substancialmente	Abbr=Yes
substancialmente	substancialmente	_
substantiva	substantivamente	Abbr=Yes
substantivamente	substantivamente	_
subterranea	subterraneamente	Abbr=Yes
subterraneamente	subterraneamente	_
subvencional	subvencionalmente	Abbr=Yes
subvencionalmente	subvencionalmente	_
sucessiva	sucessivamente	Abbr=Yes
sucessivamente	sucessivamente	_
sucinta	sucintamente	Abbr=Yes
sucintamente	sucintamente	_
suficiente	suficientemente	Abbr=Yes
suficientemente	suficientemente	_
sufixal	sufixalmente	Abbr=Yes
sufixalmente	sufixalmente	_
sugestiva	sugestivamente	Abbr=Yes
sugestivamente	sugestivamente	_
suicida	suicidamente	Abbr=Yes
suicidamente	suicidamente	_
sulina	sulinamente	Abbr=Yes
sulinamente	sulinamente	_
suma	sumamente	Abbr=Yes
sumamente	sumamente	_
sumaria	sumariamente	Abbr=Yes
sumariamente	sumariamente	_
suntuosa	suntuosamente	Abbr=Yes
suntuosamente	suntuosamente	_
super	super	_
superficial	superficialmente	Abbr=Yes
superficialmente	superficialmente	_
superior	superiormente	Abbr=Yes
superiormente	superiormente	_
superlativa	superlativamente	Abbr=Yes
superlativamente	superlativamente	_
superveniente	supervenientemente	Abbr=Yes
supervenientemente	supervenientemente	_
supina	supinamente	Abbr=Yes
supinamente	supinamente	_
supletiva	supletivamente	Abbr=Yes
supletivamente	supletivamente	_
suposta	supostamente	Abbr=Yes
supostamente	supostamente	_
suprema	supremamente	Abbr=Yes
supremamente	supremamente	_
surda	surdamente	Abbr=Yes
surdamente	surdamente	_
surpreendente	surpreendentemente	Abbr=Yes
surpreendentemente	surpreendentemente	_
surreal	surrealmente	Abbr=Yes
surrealmente	surrealmente	_
suruba	surubamente	Abbr=Yes
surubamente	surubamente	_
suscetivel	suscetivelmente	Abbr=Yes
suscetivelmente	suscetivelmente	_
suspeita	suspeitamente	Abbr=Yes
suspeitamente	suspeitamente	_
sustentavel	sustentavelmente	Abbr=Yes
sustentavelmente	sustentavelmente	_
sutil	sutilmente	Abbr=Yes
sutilmente	sutilmente	_
sério	sério	_
só	só	_
súbito	súbito	_
tacanha	tacanhamente	Abbr=Yes
tacanhamente	tacanhamente	_
tacita	tacitamente	Abbr=Yes
tacitamente	tacitamente	_
tagarela	tagarelamente	Abbr=Yes
tagarelamente	tagarelamente	_
talentosa	talentosamente	Abbr=Yes
talentosamente	talentosamente	_
talvez	talvez	_
também	também	_
tampouco	tampouco	_
tangenciada	tangenciadamente	Abbr=Yes
tangenciadamente	tangenciadamente	_
tangencial	tangencialmente	Abbr=Yes
tangencialmente	tangencialmente	_
tangenciosamente	tangenciosamente	_
tangente	tangentemente	Abbr=Yes
tangentemente	tangentemente	_
tanto	tanto	_
tarde	tarde	_
tardia	tardiamente	Abbr=Yes
tardiamente	tardiamente	_
tardinho	tardinho	_
tatica	taticamente	Abbr=Yes
taticamente	taticamente	_
taxativa	taxativamente	Abbr=Yes
taxativamente	taxativamente	_
teatral	teatralmente	Abbr=Yes
teatralmente	teatralmente	_
tecnica	tecnicamente	Abbr=Yes
tecnicamente	tecnicamente	_
tecnocratica	tecnocraticamente	Abbr=Yes
tecnocraticamente	tecnocraticamente	_
tecnologica	tecnologicamente	Abbr=Yes
tecnologicamente	tecnologicamente	_
tectonica	tectonicamente	Abbr=Yes
tectonicamente	tectonicamente	_
tediosa	tediosamente	Abbr=Yes
tediosamente	tediosamente	_
teimosa	teimosamente	Abbr=Yes
teimosamente	teimosamente	_
telegrafica	telegraficamente	Abbr=Yes
telegraficamente	telegraficamente	_
temariamente	temariamente	_
tematica	tematicamente	Abbr=Yes
tematicamente	tematicamente	_
temeraria	temerariamente	Abbr=Yes
temerariamente	temerariamente	_
temperamental	temperamentalmente	Abbr=Yes
temperamentalmente	temperamentalmente	_
tempestiva	tempestivamente	Abbr=Yes
tempestivamente	tempestivamente	_
tempestuosa	tempestuosamente	Abbr=Yes
tempestuosamente	tempestuosamente	_
temporal	temporalmente	Abbr=Yes
temporalmente	temporalmente	_
temporaria	temporariamente	Abbr=Yes
temporariamente	temporariamente	_
tenaz	tenazmente	Abbr=Yes
tenazmente	tenazmente	_
tendenciosa	tendenciosamente	Abbr=Yes
tendenciosamente	tendenciosamente	_
tendente	tendentemente	Abbr=Yes
tendentemente	tendentemente	_
tenebrosa	tenebrosamente	Abbr=Yes
tenebrosamente	tenebrosamente	_
tentativa	tentativamente	Abbr=Yes
tentativamente	tentativamente	_
teologica	teologicamente	Abbr=Yes
teologicamente	teologicamente	_
teorica	teoricamente	Abbr=Yes
teoricamente	teoricamente	_
terapeutica	terapeuticamente	Abbr=Yes
terapeuticamente	terapeuticamente	_
termeletrica	termeletricamente	Abbr=Yes
termeletricamente	termeletricamente	_
termica	termicamente	Abbr=Yes
termicamente	termicamente	_
terminal	terminalmente	Abbr=Yes
terminalmente	terminalmente	_
terminante	terminantemente	Abbr=Yes
terminantemente	terminantemente	_
termodinamica	termodinamicamente	Abbr=Yes
termodinamicamente	termodinamicamente	_
termoeletrica	termoeletricamente	Abbr=Yes
termoeletricamente	termoeletricamente	_
terna	ternamente	Abbr=Yes
ternamente	ternamente	_
territorial	territorialmente	Abbr=Yes
territorialmente	territorialmente	_
terrivel	terrivelmente	Abbr=Yes
terrivelmente	terrivelmente	_
terrorista	terroristamente	Abbr=Yes
terroristamente	terroristamente	_
testemunhal	testemunhalmente	Abbr=Yes
testemunhalmente	testemunhalmente	_
textual	textualmente	Abbr=Yes
textualmente	textualmente	_
timida	timidamente	Abbr=Yes
timidamente	timidamente	_
tipica	tipicamente	Abbr=Yes
tipicamente	tipicamente	_
tipografica	tipograficamente	Abbr=Yes
tipograficamente	tipograficamente	_
tiranica	tiranicamente	Abbr=Yes
tiranicamente	tiranicamente	_
tola	tolamente	Abbr=Yes
tolamente	tolamente	_
tolerante	tolerantemente	Abbr=Yes
tolerantemente	tolerantemente	_
toleravel	toleravelmente	Abbr=Yes
toleravelmente	toleravelmente	_
tonal	tonalmente	Abbr=Yes
tonalmente	tonalmente	_
tonica	tonicamente	Abbr=Yes
tonicamente	tonicamente	_
tonta	tontamente	Abbr=Yes
tontamente	tontamente	_
topetuda	topetudamente	Abbr=Yes
topetudamente	topetudamente	_
topica	topicamente	Abbr=Yes
topicamente	topicamente	_
topografica	topograficamente	Abbr=Yes
topograficamente	topograficamente	_
toponomastica	toponomasticamente	Abbr=Yes
toponomasticamente	toponomasticamente	_
torrencial	torrencialmente	Abbr=Yes
torrencialmente	torrencialmente	_
tortuosa	tortuosamente	Abbr=Yes
tortuosamente	tortuosamente	_
torturante	torturantemente	Abbr=Yes
torturantemente	torturantemente	_
tosca	toscamente	Abbr=Yes
toscamente	toscamente	_
total	totalmente	Abbr=Yes
totalitarista	totalitaristamente	Abbr=Yes
totalitaristamente	totalitaristamente	_
totalmente	totalmente	_
trabalhosa	trabalhosamente	Abbr=Yes
trabalhosamente	trabalhosamente	_
tradicional	tradicionalmente	Abbr=Yes
tradicionalista	tradicionalistamente	Abbr=Yes
tradicionalistamente	tradicionalistamente	_
tradicionalmente	tradicionalmente	_
tragica	tragicamente	Abbr=Yes
tragicamente	tragicamente	_
traiçoeira	traiçoeiramente	Abbr=Yes
traiçoeiramente	traiçoeiramente	_
tranquila	tranquilamente	Abbr=Yes
tranquilamente	tranquilamente	_
tranquilizante	tranquilizantemente	Abbr=Yes
tranquilizantemente	tranquilizantemente	_
transcendente	transcendentemente	Abbr=Yes
transcendentemente	transcendentemente	_
transitoria	transitoriamente	Abbr=Yes
transitoriamente	transitoriamente	_
translucida	translucidamente	Abbr=Yes
translucidamente	translucidamente	_
transoceanica	transoceanicamente	Abbr=Yes
transoceanicamente	transoceanicamente	_
transparente	transparentemente	Abbr=Yes
transparentemente	transparentemente	_
transversa	transversamente	Abbr=Yes
transversal	transversalmente	Abbr=Yes
transversalmente	transversalmente	_
transversamente	transversamente	_
trefega	trefegamente	Abbr=Yes
trefegamente	trefegamente	_
tremenda	tremendamente	Abbr=Yes
tremendamente	tremendamente	_
tributavel	tributavelmente	Abbr=Yes
tributavelmente	tributavelmente	_
tridimensional	tridimensionalmente	Abbr=Yes
tridimensionalmente	tridimensionalmente	_
trienal	trienalmente	Abbr=Yes
trienalmente	trienalmente	_
trimestral	trimestralmente	Abbr=Yes
trimestralmente	trimestralmente	_
tripla	triplamente	Abbr=Yes
triplamente	triplamente	_
triste	tristemente	Abbr=Yes
tristemente	tristemente	_
triunfal	triunfalmente	Abbr=Yes
triunfalmente	triunfalmente	_
triunfante	triunfantemente	Abbr=Yes
triunfantemente	triunfantemente	_
trivial	trivialmente	Abbr=Yes
trivialmente	trivialmente	_
tropical	tropicalmente	Abbr=Yes
tropicalmente	tropicalmente	_
trás	trás	_
tumultuosa	tumultuosamente	Abbr=Yes
tumultuosamente	tumultuosamente	_
turistica	turisticamente	Abbr=Yes
turisticamente	turisticamente	_
turva	turvamente	Abbr=Yes
turvamente	turvamente	_
tão	tão	_
ulterior	ulteriormente	Abbr=Yes
ulteriormente	ulteriormente	_
ultima	ultimamente	Abbr=Yes
ultimamente	ultimamente	_
ultra	ultra	_
umbilical	umbilicalmente	Abbr=Yes
umbilicalmente	umbilicalmente	_
unanime	unanimemente	Abbr=Yes
unanimemente	unanimemente	_
unica	unicamente	Abbr=Yes
unicamente	unicamente	_
unificada	unificadamente	Abbr=Yes
unificadamente	unificadamente	_
uniforme	uniformemente	Abbr=Yes
uniformemente	uniformemente	_
unilateral	unilateralmente	Abbr=Yes
unilateralmente	unilateralmente	_
universal	universalmente	Abbr=Yes
universalmente	universalmente	_
univoca	univocamente	Abbr=Yes
univocamente	univocamente	_
urbanistica	urbanisticamente	Abbr=Yes
urbanisticamente	urbanisticamente	_
urgente	urgentemente	Abbr=Yes
urgentemente	urgentemente	_
usual	usualmente	Abbr=Yes
usualmente	usualmente	_
util	utilmente	Abbr=Yes
utilitarista	utilitaristamente	Abbr=Yes
utilitaristamente	utilitaristamente	_
utilmente	utilmente	_
utopica	utopicamente	Abbr=Yes
utopicamente	utopicamente	_
vacilante	vacilantemente	Abbr=Yes
vacilantemente	vacilantemente	_
vadia	vadiamente	Abbr=Yes
vadiamente	vadiamente	_
vaga	vagamente	Abbr=Yes
vagabunda	vagabundamente	Abbr=Yes
vagabundamente	vagabundamente	_
vagamente	vagamente	_
vagante	vagantemente	Abbr=Yes
vagantemente	vagantemente	_
vagarosa	vagarosamente	Abbr=Yes
vagarosamente	vagarosamente	_
valente	valentemente	Abbr=Yes
valentemente	valentemente	_
valentona	valentonamente	Abbr=Yes
valentonamente	valentonamente	_
valida	validamente	Abbr=Yes
validamente	validamente	_
valiosa	valiosamente	Abbr=Yes
valiosamente	valiosamente	_
vantajosa	vantajosamente	Abbr=Yes
vantajosamente	vantajosamente	_
variante	variantemente	Abbr=Yes
variantemente	variantemente	_
variavel	variavelmente	Abbr=Yes
variavelmente	variavelmente	_
vascular	vascularmente	Abbr=Yes
vascularmente	vascularmente	_
vasta	vastamente	Abbr=Yes
vastamente	vastamente	_
veemente	veementemente	Abbr=Yes
veementemente	veementemente	_
vegetal	vegetalmente	Abbr=Yes
vegetalmente	vegetalmente	_
velada	veladamente	Abbr=Yes
veladamente	veladamente	_
veladora	veladoramente	Abbr=Yes
veladoramente	veladoramente	_
veloz	velozmente	Abbr=Yes
velozmente	velozmente	_
veneravel	veneravelmente	Abbr=Yes
veneravelmente	veneravelmente	_
verbal	verbalmente	Abbr=Yes
verbalmente	verbalmente	_
verdadeira	verdadeiramente	Abbr=Yes
verdadeiramente	verdadeiramente	_
vergonhosa	vergonhosamente	Abbr=Yes
vergonhosamente	vergonhosamente	_
vernacula	vernaculamente	Abbr=Yes
vernaculamente	vernaculamente	_
verossimil	verossimilmente	Abbr=Yes
verossimilmente	verossimilmente	_
vertical	verticalmente	Abbr=Yes
verticalmente	verticalmente	_
vertiginosa	vertiginosamente	Abbr=Yes
vertiginosamente	vertiginosamente	_
vibrante	vibrantemente	Abbr=Yes
vibrantemente	vibrantemente	_
vicaria	vicariamente	Abbr=Yes
vicariamente	vicariamente	_
vigilante	vigilantemente	Abbr=Yes
vigilantemente	vigilantemente	_
vigorosa	vigorosamente	Abbr=Yes
vigorosamente	vigorosamente	_
vil	vilmente	Abbr=Yes
vilipendiosa	vilipendiosamente	Abbr=Yes
vilipendiosamente	vilipendiosamente	_
vilmente	vilmente	_
vilã	vilãmente	Abbr=Yes
vilãmente	vilãmente	_
violenta	violentamente	Abbr=Yes
violentamente	violentamente	_
virge	virgemente	Abbr=Yes
virgemente	virgemente	_
virginal	virginalmente	Abbr=Yes
virginalmente	virginalmente	_
viril	virilmente	Abbr=Yes
virilmente	virilmente	_
virtual	virtualmente	Abbr=Yes
virtualmente	virtualmente	_
virtuosa	virtuosamente	Abbr=Yes
virtuosamente	virtuosamente	_
visceral	visceralmente	Abbr=Yes
visceralmente	visceralmente	_
viscosa	viscosamente	Abbr=Yes
viscosamente	viscosamente	_
visionaria	visionariamente	Abbr=Yes
visionariamente	visionariamente	_
visivel	visivelmente	Abbr=Yes
visivelmente	visivelmente	_
visual	visualmente	Abbr=Yes
visualmente	visualmente	_
vital	vitalmente	Abbr=Yes
vitalmente	vitalmente	_
vitoriosa	vitoriosamente	Abbr=Yes
vitoriosamente	vitoriosamente	_
viva	vivamente	Abbr=Yes
vivamente	vivamente	_
vivida	vividamente	Abbr=Yes
vividamente	vividamente	_
vocal	vocalmente	Abbr=Yes
vocalica	vocalicamente	Abbr=Yes
vocalicamente	vocalicamente	_
vocalmente	vocalmente	_
voluntaria	voluntariamente	Abbr=Yes
voluntariamente	voluntariamente	_
voluntariosa	voluntariosamente	Abbr=Yes
voluntariosamente	voluntariosamente	_
voraz	vorazmente	Abbr=Yes
vorazmente	vorazmente	_
vulgar	vulgarmente	Abbr=Yes
vulgarmente	vulgarmente	_
vulneravel	vulneravelmente	Abbr=Yes
vulneravelmente	vulneravelmente	_
zelosa	zelosamente	Abbr=Yes
zelosamente	zelosamente	_
única	única	_
