como	como	_
contudo	contudo	_
e	e	_
enquanto	enquanto	_
entretanto	entretanto	_
então	então	_
já	já	_
logo	logo	_
mas	mas	_
nem	nem	_
ora	ora	_
ou	ou	_
pois	pois	_
porquanto	porquanto	_
porque	porque	_
portanto	portanto	_
porém	porém	_
quando	quando	_
quanto	quanto	_
que	que	_
quer	quer	_
seja	seja	_
senão	senão	_
tanto	tanto	_
todavia	todavia	_
