adeus	adeus	_
ah	ah	_
ai	ai	_
amém	amém	_
arre	arre	_
atenção	atenção	_
ave	ave	_
caramba	caramba	_
coragem	coragem	_
eia	eia	_
eita	eita	_
eureca	eureca	_
hein	hein	_
hem	hem	_
heureca	heureca	_
hum	hum	_
hummm	hummm	_
hurra	hurra	_
ih	ih	_
nossa	nossa	_
né	né	_
oh	oh	_
oi	oi	_
ok	ok	_
olá	olá	_
ora	ora	_
poxa	poxa	_
pqp	pqp	_
pronto	pronto	_
psit	psit	_
psiu	psiu	_
pô	pô	_
que	que	_
tchau	tchau	_
ufa	ufa	_
uh	uh	_
ui	ui	_
ué	ué	_
xi	xi	_
ão	ão	_
ó	ó	_
